border_size=1
usage=map

Xu, Xu, Xu, Xu, Xu, Xu, Xu, Xu, Xu, Xu, Xu, Xu, Xu, Xu, Xu, Xu, Xu, Xu, Xu, Xu, Xu, Xu, Xu, Xu, Xu, Xu, Xu, Xu, Xu, Xu, Xu, Xu, Xu, Xu, Xu, Xu, Xu, Xu
Xu, Uu, Uu, Uu, Uu, Uu, Uu, Uu, Uu, Uu, Uu, Uu, Uu, Uu, Uu, Uu, Uu, Uu, Uu, Uu, Uu, Uu, Uu, Uu, Uu, Uu, Uu, Uu, Uu, Uu, Uu, Uu, Uu, Uu, Uu, Uu, Uu, Xu
Xu, Uu, Uu, Uu, Uu, Uu, Uu^Tf, Uu, Uu, Uu, Uu, Uu, Uu, Uu, Uu, Uu, Uu, Uu, Uu, Uu, Uu, Uu, Uu, Uu, Uu, Uu, Uu, Uu, Uu, Uu, Uu^Vu, Uu, Uu, Uu, Uu, Uu, Uu, Xu
Xu, Uu, Uu, Uu, Uu, Uu, Uu, Uu, Uu, Uu, Uu, Uu, Uu, Uu, Uu, Uu, Uu, Uu, Uh, Uu, Uu, Uu, Uu, Uu, Uu, Uu, Uu, Uu, Uu, Uu, Uu, Uu, Uu, Uu, Uu, Uu^Tf, Uu, Xu
Xu, Uu, Uu, Uu, Uu, Uu, Uu, Uu, Uu, Uu, Uu, Uu, Uu, Uu, Uu, Uu, Uu, Uu, Uu, Uu, Uu, Uu, Uu, Uu, Uu, Uu, Uu, Uu^Tf, Uu, Uu, Uu, Uu, Uu, Urb, Uu, Uu, Uu, Xu
Xu, Uu, Uu, Uu, Uu, Uu, Uu, Uu, Uu, Uu, Uu, Uu, Uu, Uu, Uu, Uu, Uu, Uu, Uu, Urb, Uu, Uh, Uu, Uu, Uu, Uu, Uu, Uu, Uu, Uu, Uu, Uu, Uu, Uu, Uu, Uu, Uu, Xu
Xu, Uu, Uu, Uu, Uu, Uu, Uu, Uu, Uu, Uu, Uu, Uu^Tf, Uu, Uu, Uu, Uu, Uu, Uu, Uu, Urb, Uu, Uu, Uu, Uu, Uu, Uu, Uu, Uu, Uu, Uu, Uu, Uu, Uu, Uu, Uu, Uu, Uu, Xu
Xu, Uu, Uu, Uu^Tf, Uu, Uu, Uu, Uu, Uu, Uu, Uu, Uu^Vu, Uu, Uu, Uu, Uu, Uu, Uu, Uu, Urb, Uu, Uu, Uu, Uu, Uh, Uu, Uu, Uu, Uu, Uu, Uu, Uu, Uu, Uu, Uu, Uu, Uu, Xu
Xu, Uu, Uu, Uu, Uh, Uu, Uu, Uu, Uu, Uu, Uu, Uu, Uu, Uu, Uu, Uu, Uu, Uu, Uu, Urb, Uu, Uu, Uu, Uu^Vu, Uu, Uu, Uu, Uu, Uu, Uu, Uu, Uu, Uu^Tf, Uu, Uu, Uu, Uu, Xu
Xu, Uu, Uu, Uu, Uu, Uu, Uu, Uu, Uu, Uu, Uu, Urb^Ebn, Uu, Uu, Uu, Uu, Uu, Uu, Uu, Urb, Uu, Uu, Uu, Uu, Uu^Tf, Uu, Uu, Uh, Uu, Uu, Uu, Uu, Uu, Uu, Uu, Uu^Vu, Uu, Xu
Xu, Uu, Uu, Uu, Uu, Uu, Uu, Uh, Uu, Uu, Uu, Uu, Uu, Uu, Uu, Uu, Uu^Tf, Uu, Uu, Urb, Uu, Uu, Uu, Uu, Uu, Uu, Uu, Uu, Uu, Uu, Uu, Uu, Uu, Uu, Uu, Uu, Uu, Xu
Xu, Uu, Uu, Uu, Uu, Uu, Uu, Uu, Uu^Tf, Uu, Uu, Uu, Uu, Uu, Uu, Uu, Uu, Uu, Uu, Urb, Uu, Uu, Uu, Uu, Uu, Uu, Uu, Uu, Uu, Uu, Uh, Uu, Uu, Uu, Uu, Uu, Uu, Xu
Xu, Uu, Uu, Uu, Uu, Uu, Uu, Uu, Uu, Uu, Uh, Uu, Uu, Uu, Uu, Uu, Uu, Uu, Uu, Urb, Uu, Uu, Uu, Uu, Uu, Uu, Uu, Uu, Uu, Uu, Uu, Uu, Uu, Uu, Uu, Uu, Uu, Xu
Xu, Uu, Cud, Cud, Uu^Vu, Uu, Uu, Uu, Uu, Uu, Uu, Uu, Uu, Uu, Uu, Uu, Uu, Uu, Uu, Urb, Uu, Uu, Uu, Uu, Uu, Uu, Uu, Uu, Uu, Uu^Tf, Uu, Uu, Cud, Cud, Uu, Uu, Uu, Xu
Xu, Urb, Cud, Kud, Cud, Uu, Uu, Urb^Edb, Uu, Uu, Uu, Uu, Uu, Uh, Uu, Uu, Uu^Vu, Uu, Uu, Urb, Uu, Uu^Tf, Uu, Uu, Uu, Uu, Uu, Uu, Uu, Uu, Uu, Uu, Cud, Kud, Cud, Uu, Uu, Xu
Xu, Uu, Uu, Cud, Cud, Uu, Uu, Uu, Uu, Uu, Uu, Uu, Ur, Ur, Ur, Ur, Ur, Ur, Qxu^Bs|, Urb, Qxu^Bs|, Ur, Ur, Ur, Ur, Uu, Uu, Uu, Uu^Vu, Uu, Uu, Uu, Uu, Cud, Cud, Uu, Uu, Xu
Xu, Uu, Uu, Uu, Uu, Uu^Tf, Uu, Uu, Uu, Uu, Uu, Uu, Uu, Uu, Uu, Uu, Uh, Uu, Uu, Urb, Uu, Uu, Uu, Uu, Uu, Uu, Uu, Uu, Uu, Uu, Uu, Uu, Uu, Uu, Uu, Uu, Uu, Xu
Xu, Uu, Uu, Uu, Uu, Uu, Uu, Uu, Uu, Uu, Uu, Uu, Uu, Uu, Uu, Uu, Uu, Uu, Uu, Urb, Uu, Uu, Uu, Uu, Uu, Uu, Uu, Uu, Uu, Uu, Uu, Uu, Uu, Uu, Uu^Tf, Uu, Uu, Xu
Xu, Uu, Uu, Uu, Uu, Uu, Uu, Uu, Uu, Uu, Uu, Uu, Uu, Uu, Uu, Uu, Uu, Uu, Uu, Urb, Uu, Uu, Uu, Uu, Uu, Uu, Uu^Tf, Uu, Uu, Uu, Uu, Uu, Uu, Uu, Uu, Uu, Uu, Xu
Xu, Uu, Uu, Uu, Uu, Uu, Uu, Uu, Uu, Uu, Uu, Uu, Uu, Uu, Uu, Uu, Uu, Uu, Uu^Tf, Urb, Uu, Uu, Uu, Uu, Urb^Ebn, Uu, Uu, Uu, Uu, Uu, Uu, Uu, Uu, Uu, Uu, Uu, Uu, Xu
Xu, Uu, Uu, Uu, Uu, Uu, Uu, Uu, Uu, Uu^Vu, Uu^Tf, Uu, Uu, Uu, Uu, Uu, Uu, Uu, Uu, Urb, Uu, Uu, Uh, Uu, Uu, Uu, Uu, Uu, Uu, Uu, Uu, Uu, Uu, Uu, Uu, Uu, Uu, Xu
Xu, Uu, Uh, Uu, Uu, Uu, Uu, Uu, Uu, Uu, Uu, Uu, Uu, Uu, Uu, Uu, Uu, Uu, Uu, Urb, Uu, Uu^Vu, Uu, Uu, Uu, Uu, Uu, Uu, Uu, Uu, Uu, Uu, Uu, Uu, Uu, Uu, Uu, Xu
Xu, Uu, Uu, Uu, Uu, Uu, Uu, Uu, Uu, Uu, Uu, Uu, Uu, Uu, Uu, Uu, Uu, Uu, Uu, Urb, Uu, Uu, Uu, Uu, Uu, Uh, Uu, Uu, Uu, Uu, Uu, Uu^Tf, Uu, Uu^Vu, Uu, Uu, Uu, Xu
Xu, Uu, Uu, Uu, Uu, Uh, Uu, Uu, Uu, Uu, Uu, Uu, Uu, Uu, Uu, Uu, Uu, Uu, Uu, Urb, Uu, Uu, Uu, Uu^Tf, Uu, Uu, Uu, Uu, Uu, Uu, Uu, Uu, Uu, Uu, Uu, Uu, Uu, Xu
Xu, Uu, Uu, Uu, Uu, Uu, Uu, Uu, Uu, Uu, Uu, Uu, Uu, Uu, Uu, Uu^Tf, Uu, Uu, Uu, Urb, Uu, Uu, Uu, Uu, Uu, Uu, Uu, Uu, Uh, Uu, Uu, Uu, Uu, Urb, Uu, Uu, Uu, Xu
Xu, Uu, Uu, Uu, Uu, Uu, Uu, Uu^Tf, Uh, Uu, Uu, Uu, Uu, Uu, Uu, Uu, Uu, Uu, Uu, Uu, Uu, Uu, Uu, Uu, Uu, Uu, Uu, Uu, Uu, Uu, Uu, Uu, Uu, Uu, Uu, Uu, Uu, Xu
Xu, Uu, Uu^Vu, Uu, Uu, Uu, Uu, Uu, Uu, Uu, Uu, Uu, Uu, Uu, Uu, Uu, Uu, Uu, Uu, Uu, Uu, Uu, Uu, Uu, Uu, Uu, Uu, Uu, Uu, Uu, Uu, Uh, Uu, Uu, Uu, Uu, Uu, Xu
Xu, Uu, Uu, Uu, Uu, Uu, Uu, Uu, Uu, Uu, Uu, Uh, Uu, Uu, Uu^Vu, Uu, Uu, Uu, Uu, Uu, Uu, Uu, Uu, Uu, Uu, Uu, Uu, Uu, Uu^Tf, Uu, Uu, Uu, Uu, Uu, Uu, Uu, Uu, Xu
Xu, Uu, Uu, Uu, Uu, Uu, Uu, Uu, Uu, Uu, Uu, Uu, Uu, Uu, Uu, Uu, Uu, Uu, Uu, Uu, Uu, Uu, Uu, Uu, Uu, Uu, Uu, Uu, Uu, Uu, Uu, Uu, Uu, Uu, Uu, Uu, Uu, Xu
Xu, Xu, Xu, Xu, Xu, Xu, Xu, Xu, Xu, Xu, Xu, Xu, Xu, Xu, Xu, Xu, Xu, Xu, Xu, Xu, Xu, Xu, Xu, Xu, Xu, Xu, Xu, Xu, Xu, Xu, Xu, Xu, Xu, Xu, Xu, Xu, Xu, Xu
