border_size=1
usage=map

Xu, Xu, Xu, Xu, Xu, Xu, Xu, Xu, Xu, Xu, Xu, Xu, Xu, Xu, Xu, Xu, Xu, Xu, Xu, Xu, Xu, Xu, Xu, Xu, Xu, Xu, Xu, Xu, Xu, Xu, Xu, Xu, Xu, Xu, Xu, Xu, Xu, Xu, Xu, Xu
Xu, Uu, Uu, Uu, Uu, Uu, Uu, Uu, Uu, Uu, Uu, Uu, Uu, Uu, Uu, Uu, Uu, Uu, Uu, Uu, Uu, Uu, Uu, Uu, Uu, Uu, Uu, Uu, Uu, Uu, Uu, Uu, Uu, Uu, Uu, Uu, Uu, Uu, Uu, Xu
Xu, Uu, Uu, Uu, Uu, Uu, Uu, Uu, Uu, Uu, Uu, Uu, Uu, Uu, Uu, Uu, Uu, Uu, Uu, Uu, Uu, Uu, Uu, Uu, Uu, Uu, Uu, Uu, Uu^Tf, Uu, Uh, Uu, Uu, Uu, Uu, Uu, Uu^Vu, Uu, Uu, Xu
Xu, Uu, Uu, Uu, Uu, Uu, Uu, Uu, Uu, Uu, Uh, Uu, Uu, Uu, Uu, Uu, Uu, Uu, Uu, Uu, Uu^Tf, Uu, Uu, Uu, Uu, Uu, Uu, Uu, Uu, Uu, Uu, Uu, Uu, Uu, Uu, Uu, Uu, Uu, Uu, Xu
Xu, Uu, Uu, Uu, Uu, Uu, Uu, Uu, Uu, Uu, Uu, Uu, Uu^Tf, Uu, Uu, Uu, Uu, Uu, Uu, Uu, Uu, Uu, Uu, Uu, Uu, Uu, Uu, Uu, Uu, Uu, Uu, Uu, Uu, Uh, Uu, Urb, Uu, Uu, Uu, Xu
Xu, Uu, Uu, Urb, Urb, Urb, Xot, Urb, Urb, Urb, Urb, Urb, Xot, Urb, Urb, Urb, Urb, Urb, Xot, Urb, Urb, Urb, Urb, Urb, Xot, Urb, Urb, Urb, Urb, Urb, Xot, Urb, Urb, Urb, Urb, Urb, Xot, Uu, Uu, Xu
Xu, Uu, Uu, Uu, Uu, Uu^Vu, Uu, Uu, Uu, Uu, Uu, Uu, Uu, Uu, Uu, Uu, Uu, Uu, Uu, Uu, Uu, Uu, Uu, Uu, Uu, Uu, Uu, Uu, Uu, Uu, Uu, Uu, Uu, Uu^Tf, Uu, Uu, Uh, Uu, Uu, Xu
Xu, Uu, Uu, Uu, Uu, Uu, Uu, Uu, Uu, Uu, Uu, Uu, Urb^Ebn, Uu, Uu, Uu, Uh, Uu^Vu, Uu, Uu, Uu, Uu, Uu, Uu, Uu, Uu^Tf, Uu, Uu, Uu, Uu, Uu, Uu, Uu, Uu, Uu, Uu, Uu, Uu, Uu, Xu
Xu, Uu, Uu, Uu, Uu, Uu, Uu, Uu, Uu, Uu, Uu, Uu, Uu, Uu, Uu, Uu, Uu, Uu^Tf, Uu, Uu, Uu, Uu, Uu, Uu, Uu, Uu, Uu, Uu, Uu, Uu^Vu, Uu, Uu, Uu, Uu, Uu, Uu, Uu, Uu, Uu, Xu
Xu, Uu, Uu, Uu, Uu, Uu, Uu, Uu, Uu, Uu^Tf, Uu, Uu, Uu, Uu, Uu, Uu, Uu, Uu, Uu, Urb^Ebn, Uu, Uu, Uu, Uu, Uu, Uu, Uu, Uu, Uu, Uu, Uu, Uu, Uu, Uu, Uu, Uu, Uu, Uu, Uu, Xu
Xu, Uu, Uu, Urb, Urb, Urb, Xot, Urb, Urb, Urb, Urb, Urb, Xot, Urb, Urb, Urb, Urb, Urb, Xot, Urb, Urb, Urb, Urb, Urb, Xot, Urb, Urb, Urb, Urb, Urb, Xot, Urb, Urb, Urb, Urb, Urb, Xot, Uu, Uu, Xu
Xu, Uu, Uu, Uu, Uu, Uu, Uu, Uu, Uu, Uu, Uu, Uu, Uu, Uu, Uu, Uu, Uu, Uu, Uu, Uu, Uu, Uu, Uh, Uu, Uu, Uu, Uu, Uu, Uu, Uu, Uu^Tf, Uu, Uu, Uu, Uu, Uu, Uu, Uu, Uu, Xu
Xu, Uu, Uh, Uu, Uu, Uu, Uu, Uu, Uu, Uu, Uu, Uu, Uu, Uu, Uu, Uu, Uu, Uu, Uu, Uu, Uu, Uu, Uu^Tf, Uu, Uu, Uu, Uu, Uu, Uu, Uu, Uu, Uu, Uu, Uu, Uu, Uu, Uu, Uu, Uu, Xu
Xu, Uu, Uu, Uu, Uu, Uu, Uu, Uu, Uu, Uu, Uu^Vu, Uu, Uu, Uu, Uu^Tf, Uu, Uu, Uu, Uu, Uu, Uu, Uu, Uu, Uu, Uu, Uh, Uu, Uu, Uu, Uu, Uu, Uu, Uu, Uu, Uu, Uu, Uu, Uu, Uu, Xu
Xu, Uu, Cud, Cud, Uu, Uh, Uu^Tf, Uu, Uu, Uu, Uu, Uu, Uu, Uu, Uu, Uu, Uu, Uu, Uu, Uu, Uu, Uu, Uu^Vu, Uu, Uu, Uu, Uu, Uu, Uu, Uu, Uu, Uu, Uu, Uu, Cud, Cud, Uu, Uu, Uu, Xu
Xu, Urb, Cud, Kud, Cud, Urb, Xot, Urb^Edb, Urb, Urb, Urb, Urb, Xot, Urb, Urb, Urb, Urb, Urb, Xot, Urb, Urb, Urb, Urb, Urb, Xot, Urb, Urb, Urb, Urb, Urb, Xot, Urb, Urb, Urb, Cud, Kud, Cud, Uu, Uu, Xu
Xu, Uu, Uu, Cud, Cud, Uu, Uu, Uu, Uh, Uu, Uu, Uu, Uu, Uu, Uu, Uu, Uu, Uu, Uu, Uu, Uu, Uu, Uu, Uu, Uu, Uu, Uu, Uu^Tf, Uu, Uu, Uu, Uu, Uu, Uu, Uu, Cud, Cud, Uu, Uu, Xu
Xu, Uu, Uu, Uu, Uu, Uu, Uu, Uu, Uu, Uu, Uu, Uu, Uu, Uu, Uu, Uu, Uu, Uu, Uu, Uu^Tf, Uu, Uu, Uu, Uu, Uu, Uu, Uu, Uu, Uu, Uu, Uu, Uh, Uu, Uu, Uu, Uu, Uu, Uu, Uu, Xu
Xu, Uu, Uu, Uu, Uu, Uu, Uu, Uu, Uu, Uu, Uu, Uh, Uu, Uu, Uu, Uu, Uu, Uu, Uu, Uu, Uu, Uu, Uu, Uu, Uu, Uu, Uu, Uu, Uu, Uu, Uu, Uu, Uu, Uu, Uu, Uu, Uu, Uu, Uu, Xu
Xu, Uu, Uu, Uu^Tf, Uu, Uu, Uu, Uu, Uu, Uu, Uu, Uu, Uu, Uu, Uu, Uu, Uu, Uu, Uu, Uu, Uu, Uu, Uu, Uu, Uu, Uu, Uu, Uu, Uu, Uu, Uu, Uu, Uu, Uu, Uh, Uu, Uu, Uu, Uu, Xu
Xu, Uu, Uu, Urb, Urb, Urb, Xot, Urb, Urb, Urb, Urb, Urb, Xot, Urb, Urb, Urb, Urb, Urb, Xot, Urb, Urb, Urb, Urb, Urb, Xot, Urb, Urb, Urb, Urb, Urb, Xot, Urb, Urb, Urb, Urb, Urb, Xot, Uu, Uu, Xu
Xu, Uu, Uu, Uu, Uu, Uu, Uu, Uu, Uu, Uu, Uu, Uu, Uu, Uu, Uu, Uu, Uu, Uu, Uu, Uu, Uu, Uu, Uu, Uu, Uu^Tf, Uu, Uu, Uu^Vu, Uu, Uu, Uu, Uu, Uu, Uu, Uu, Uu, Uu, Uh, Uu, Xu
Xu, Uu, Uu, Uu, Uu, Uu, Uu, Uu, Uu, Uu, Uu, Uu, Uu, Uu, Uu, Uu, Uu^Tf, Uh, Uu, Uu, Uu, Uu, Uu, Uu, Uu, Uu, Uu, Uu, Uu, Uu, Uu, Uu, Uu, Uu, Uu, Uu, Uu, Uu, Uu, Xu
Xu, Uu, Uu, Uu, Uu, Uu, Uu, Uu, Uu^Tf, Uu, Uu, Uu, Uu, Uu, Uu, Uu, Uu, Uu, Uu, Uu, Uu, Uu, Uu, Uu, Uu, Urb^Ebn, Uu, Uu, Uu, Uu, Uu, Uu, Uu, Uu, Uu, Uu, Uu, Uu, Uu, Xu
Xu, Uu, Uu, Uu, Uu, Uu, Uu, Uu, Uu, Uu, Uu, Uu, Uu, Uu, Uu, Uu, Uu, Uu, Uu, Uu, Uh, Uu, Uu, Uu, Uu, Uu, Uu, Uu, Uu, Uu, Uu, Uu, Uu, Uu, Uu, Uu, Uu, Uu^Tf, Uu, Xu
Xu, Uu, Uu, Urb, Urb, Urb, Xot, Urb, Urb, Urb, Urb, Urb, Xot, Urb, Urb, Urb, Urb, Urb, Xot, Urb, Urb, Urb, Urb, Urb, Xot, Urb, Urb, Urb, Urb, Urb, Xot, Urb, Urb, Urb, Urb, Urb, Xot, Uu, Uu, Xu
Xu, Uu, Uu, Uu, Uu, Uu, Uu, Uu, Uu^Vu, Uu, Uu, Uu, Uu, Uu, Uu, Uu, Uu, Uu, Uu, Uu, Uu, Uu^Tf, Uu, Uh, Uu, Uu, Uu, Uu, Uu, Uu, Uu, Uu, Uu, Uu, Uu, Urb, Uu, Uu, Uu, Xu
Xu, Uu, Uu, Uh, Uu, Uu, Uu, Uu, Uu, Uu, Uu, Uu, Uu, Uu^Tf, Uu, Uu, Uu, Uu, Uu, Uu, Uu^Vu, Uu, Uu, Uu, Uu, Uu, Uu, Uu, Uu, Uu, Uu, Uu, Uu, Uu, Uu, Uu, Uu, Uu, Uu, Xu
Xu, Uu, Uu, Uu, Uu, Uu^Tf, Uu, Uu, Uu, Uu, Uu, Uu, Uu, Uu, Uu, Uu, Uu, Uu, Uu, Uu, Uu, Uu, Uu, Uu, Uu, Uu, Uh, Uu, Uu, Uu, Uu, Uu, Uu^Vu, Uu, Uu, Uu, Uu, Uu, Uu, Xu
Xu, Uu, Uu, Uu, Uu, Uu, Uh, Uu, Uu, Uu, Uu, Uu, Uu, Uu, Uu, Uu, Uu, Uu, Uu, Uu, Uu, Uu, Uu, Uu, Uu, Uu, Uu, Uu, Uu, Uu, Uu, Uu, Uu, Uu, Uu^Tf, Uu, Uu, Uu, Uu, Xu
Xu, Uu, Uu, Uu, Uu, Uu, Uu, Uu, Uu, Uu, Uu, Uu, Uu, Uu, Uu, Uu, Uu, Uu, Uu, Uu, Uu, Uu, Uu, Uu, Uu, Uu, Uu, Uu, Uu, Uu, Uu, Uu, Uu, Uu, Uu, Uu, Uu, Uu, Uu, Xu
Xu, Xu, Xu, Xu, Xu, Xu, Xu, Xu, Xu, Xu, Xu, Xu, Xu, Xu, Xu, Xu, Xu, Xu, Xu, Xu, Xu, Xu, Xu, Xu, Xu, Xu, Xu, Xu, Xu, Xu, Xu, Xu, Xu, Xu, Xu, Xu, Xu, Xu, Xu, Xu
