border_size=1
usage=map

Xu, Xu, Xu, Xu, Xu, Xu, Xu, Xu, Xu, Xu, Xu, Xu, Xu, Xu, Xu, Xu, Xu, Xu, Xu, Xu, Xu, Xu, Xu, Xu, Xu, Xu, Xu, Xu, Xu, Xu, Xu, Xu, Xu, Xu, Xu, Xu
Xu, Uu, Uu, Uu, Uu, Uu, Uu, Uu, Uu, Uu, Uu, Uu, Uu, Uu, Uu, Uu, Uu, Uu, Uu, Uu, Uu, Uu, Uu, Uu, Uu, Uu, Uu, Uu, Uu, Uu, Uu, Uu, Uu, Uu, Uu, Xu
Xu, Uu, Uu, Uu, Uu, Uu, Uu, Uu, Xu, Uu, Uu, Uu, Uu, Xu, Uh, Uu, Uu, Uu, Xu, Uu, Uu, Uu, Uu, Xu, Uu, Uu, Uu, Uu, Xu, Uu, Uu, Uu, Uu, Uu, Uu, Xu
Xu, Uu, Uu, Uu, Uu, Uu, Uu, Uu, Xu, Uu, Uu, Uu, Uu, Xu, Uu, Uu, Uu, Uu, Xu, Uu, Uu, Uu, Uu, Xu, Uu, Uu, Uu, Uu^Tf, Xu, Uu, Uu, Uu, Uu, Uu, Uu, Xu
Xu, Uu, Uu, Uu, Uu, Uu, Uu, Uu, Xu, Uu, Uu, Uu, Uu, Xu, Uu, Uu, Uu, Uh, Xu, Uu^Tf, Uu, Uu, Uu, Xu, Uu, Uu, Uu, Uu, Xu, Uu, Uu, Urb, Uu, Uu, Uu, Xu
Xu, Uu, Uu, Uu, Uu, Uu^Vu, Uu, Uu, Xu, Uu, Uu, Uu^Tf, Uu, Xu, Uu, Uu, Uu, Uu, Xu, Uu, Uu, Uu, Uu, Xu, Uu, Uu, Uu, Uu, Xu, Uu, Uu, Uu, Uu, Uu, Uu, Xu
Xu, Uu, Uu, Uu^Tf, Uu, Uu, Uu, Uu, Xu, Uu, Uu, Urb^Ebn, Uu, Xu, Uu, Uu, Uu, Uu^Vu, Xu, Uu, Uh, Uu, Uu, Xu, Uu, Uu, Uu, Uu, Uu, Uu, Uu, Uu, Uu, Uu, Uu, Xu
Xu, Uu, Uu, Uu, Uu, Uu, Uu, Uu, Xu, Uu, Uu, Uu, Uu, Xu, Uu, Uu, Uu, Uu, Xu, Uu, Uu, Uu, Uu, Xu, Uu, Uu, Uu, Uu, Uu, Uu^Vu, Uu, Uu, Uu^Tf, Uu, Uu, Xu
Xu, Uu, Uu, Uu, Uu, Uu, Uu, Uu, Uu, Uu, Uu, Uu, Uu, Xu, Uu, Uu, Uu, Uu, Xu, Uu, Uu, Uu, Uu, Xu, Uu^Tf, Uu, Uu, Uu, Uu, Uu, Uu, Uu, Uu, Uu, Uu, Xu
Xu, Uu, Uu, Uh, Uu, Uu, Uu, Uu, Uu, Uu, Uu, Uu, Uu, Xu, Uu, Uu, Uu^Tf, Urb^Ebn, Xu, Uu, Uu, Uu, Uu, Xu, Uu, Uu, Uu, Uu, Xu, Uu, Uu, Uu, Uu, Uu, Uu, Xu
Xu, Uu, Uu, Uu, Uu, Uu, Uu, Uu, Uu^Tf, Uu, Uu, Uu, Uu, Xu, Uu, Uu, Uu, Uu, Xu, Uu, Uu, Uu, Uu, Xu, Uu, Uu, Uh, Uu, Xu, Uu, Uu, Uu, Uu, Uu, Uu, Xu
Xu, Uu, Uu, Uu, Uu, Uu, Uh, Uu, Xu, Uu, Uu, Uu, Uu, Xu, Uu, Uu, Uu, Uu, Xu, Uu, Uu, Uu, Uu, Xu, Uu, Uu, Uu, Uu, Xu, Uu, Uu, Uu, Uu, Uu, Uu, Xu
Xu, Uu, Uu, Uu, Uu, Uu, Uu, Uu, Xu, Uu, Uu^Vu, Uu, Uu, Xu, Uu, Uu, Uu, Uu, Xu, Uu, Uu, Uu, Uu, Xu, Uu, Uu, Uu, Uu, Xu, Uh, Uu, Uu, Uu, Uu, Uu, Xu
Xu, Uu, Cud, Cud, Uu, Uu, Uu, Uu, Xu, Uh, Uu, Uu, Uu, Uu, Uu, Uu, Uu, Uu, Xu, Uu, Uu, Uu^Tf, Uu^Vu, Xu, Uu, Uu, Uu, Uu, Xu, Uu, Cud, Cud, Uu, Uu, Uu, Xu
Xu, Urb, Cud, Kud, Cud, Uu, Uu, Urb^Edb, Xu, Uu, Uu, Uu, Uu, Uu^Tf, Uu, Uu, Uu, Uu, Xu, Uu, Uu, Uu, Uu, Xu, Uu, Uu, Uu, Uu, Xu, Uu, Cud, Kud, Cud, Uu, Uu, Xu
Xu, Uu, Uu, Cud, Cud, Uu^Tf, Uu, Uu, Ur, Uu, Uu, Uu, Uh, Uu, Uu, Uu, Uu, Uu, Ur, Uu, Uu, Uu, Uu, Ur, Uu, Uu, Uu, Uu, Ur, Uu, Uu, Cud, Cud, Uu, Uu, Xu
Xu, Uu, Uu, Uu, Uu, Uu, Uu, Uu, Xu, Uu, Uu, Uu, Uu, Xu, Uu, Uu, Uu, Uu, Xu, Uu, Uu, Uu, Uu, Xu, Uu, Uu, Uu, Uu, Xu, Uu, Uu, Uu, Uu, Uu, Uu, Xu
Xu, Uu, Uu, Uu, Uu, Uu, Uu, Uu, Xu, Uu, Uu, Uu, Uu, Xu, Uu, Uh, Uu, Uu, Xu, Uu, Uu, Uu, Uu, Xu, Uu, Uu, Uu^Tf, Uu, Xu, Uu, Uu, Uu, Uu, Uu, Uu, Xu
Xu, Uu, Uu, Uu^Vu, Uu, Uu, Uu, Uu, Xu, Uu, Uu, Uu, Uu, Xu, Uu, Uu, Uu, Uu, Uu^Tf, Uu, Uu, Uu, Uu, Xu, Uu, Uu, Uu, Uu, Xu, Uu, Uu, Uu, Uu, Uu, Uu, Xu
Xu, Uu, Uu, Uu, Uu, Uu, Uu, Uu, Xu, Uu, Uu^Tf, Uu, Uu, Xu, Uu, Uu^Vu, Uu, Uu, Uh, Uu, Uu, Uu, Uu, Xu, Uu, Uu, Uu, Uu, Xu, Uu, Uu, Uu, Uu, Uu, Uu, Xu
Xu, Uu, Uu^Tf, Uu, Uu, Uu, Uu, Uu, Xu, Uu, Uu, Uu, Uu, Xu, Uu, Uu, Uu, Uu, Uu, Uu, Uu, Uu, Uu, Xu, Uu, Uu, Uu, Uu^Vu, Xu, Uu, Uu, Uu, Uu, Uu, Uu, Xu
Xu, Uu, Uu, Uu, Uu, Uu, Uu, Uu, Xu, Uu, Uu, Uu, Uu, Xu, Uu, Uu, Uu, Uu, Xu, Uu, Uu, Uh, Uu, Urb^Ebn, Uu, Uu, Uu, Uu, Xu, Uu, Uu, Uu^Tf, Uu, Uu, Uu, Xu
Xu, Uu, Uu, Uu, Uu, Uu, Uu, Uu, Xu, Uu, Uu, Uu, Uu, Xu, Uu, Uu, Uu, Uu, Xu, Uu, Uu, Uu, Uu, Xu, Uu, Uu, Uu, Uu, Xu, Uu, Uu, Uu, Uu, Uu, Uu, Xu
Xu, Uu, Uu, Uu, Uu, Uu, Uu, Uu, Xu, Uu, Uu, Uu, Uu, Xu, Uu, Uu^Tf, Uu, Uu, Xu, Uu, Uu, Uu, Uu, Uu, Uh, Uu, Uu, Uu, Xu, Uu, Uu, Uu, Uu, Uu, Uu, Xu
Xu, Uu, Uu, Uu, Uh, Uu, Uu, Uu^Tf, Xu, Uu, Uu, Uu, Uu, Xu, Uu, Uu, Uu, Uu, Xu, Uu, Uu, Uu, Uu, Uu, Uu, Uu, Uu, Uu, Xu, Uu, Uu, Urb, Uu, Uu, Uu, Xu
Xu, Uu, Uu, Uu, Uu, Uu, Uu, Uu, Xu, Uu, Uu, Uu, Uu, Xu, Uu, Uu, Uu, Uu, Xu, Uu, Uu, Uu, Uu, Uu, Uu, Uu, Uu, Uh, Xu, Uu, Uu, Uu, Uu, Uu, Uu, Xu
Xu, Uu, Uu, Uu, Uu, Uu, Uu, Uh, Xu, Uu, Uu, Uu, Uu, Xu, Uu, Uu, Uu, Uu, Xu, Uu, Uu^Vu, Uu, Uu, Xu, Uu, Uu, Uu, Uu, Xu, Uu, Uu, Uu, Uu, Uu, Uu, Xu
Xu, Uu, Uu, Uu, Uu, Uu, Uu, Uu, Xu, Uu, Uu, Uu, Uu, Xu, Uu, Uu, Uu, Uu, Xu, Uu, Uu^Tf, Uu, Uu, Xu, Uu, Uu, Uu, Uu, Xu, Uu, Uh, Uu, Uu^Vu, Uu, Uu, Xu
Xu, Uu, Uu, Uu, Uu, Uu, Uu, Uu, Uu, Uu, Uu, Uu, Uu, Uu, Uu, Uu, Uu, Uu, Uu, Uu, Uu, Uu, Uu, Uu, Uu, Uu, Uu, Uu, Uu, Uu, Uu, Uu, Uu, Uu, Uu, Xu
Xu, Xu, Xu, Xu, Xu, Xu, Xu, Xu, Xu, Xu, Xu, Xu, Xu, Xu, Xu, Xu, Xu, Xu, Xu, Xu, Xu, Xu, Xu, Xu, Xu, Xu, Xu, Xu, Xu, Xu, Xu, Xu, Xu, Xu, Xu, Xu
