border_size=1
usage=map

Xu, Xu, Xu, Xu, Xu, Xu, Xu, Xu, Xu, Xu, Xu, Xu, Xu, Xu, Xu, Xu, Xu, Xu, Xu, Xu, Xu, Xu, Xu, Xu, Xu, Xu, Xu, Xu, Xu, Xu, Xu, Xu, Xu, Xu, Xu, Xu, Xu, Xu, Xu, Xu, Xu, Xu
Xu, Uue, Uue, Uue, Uue, Uue, Uue, Uue, Uue, Uue, Uue, Uue, Uue, Uue, Uue, Uue, Uue, Uue, Uue, Uue, Uue, Uue, Uue, Uue, Uue, Uue, Uue, Uue, Uue, Uue, Uue, Uue, Uue, Uue, Uue, Uue, Uue, Uue, Uue, Uue, Uue, Xu
Xu, Uue, Uue, Uue, Uue, Uue, Uue, Uue, Uue, Uue, Uue, Uue, Uue, Uue, Uue, Uue, Uue, Uue, Uue, Uue, Uue, Uue, Uue, Uue, Uue, Uue, Uue, Uu^Tf, Uue, Uue, Uue, Uue, Uue, Uh, Uue, Uue, Uue, Uue, Uue, Uue, Uue, Xu
Xu, Uue, Uue, Uue, Uue, Uue, Uue, Uue, Uue, Uue, Uue, Uue, Uue, Uh, Uue, Uue, Uue, Uue, Uue, Uu^Tf, Uue, Wwg, Uue, Uue, Uue, Uue, Uue, Uue, Uue, Uue, Uue, Uue, Uue, Uue, Uue, Uue, Uue, Uue, Uue, Uue, Uue, Xu
Xu, Uue, Uue, Uue, Uue, Uue, Uue, Uue, Uue, Uue, Uue, Uu^Tf, Uue, Uue, Uue, Uue, Uue, Uue, Uue, Uue, Uue, Wwg, Uue, Uue, Uue, Uue, Uue, Uue, Uue, Uue, Uue, Uue, Uue, Uue, Uue, Uue, Uh, Urb, Uue, Uue, Uue, Xu
Xu, Uue, Uue, Uu^Tf, Uue, Uue, Uue, Uue, Uue, Uue, Uue, Uue, Uue, Uue, Uue, Uue, Uh, Uue, Uue, Uue, Uue, Sm^Bsb|, Uue, Uu^Vu, Uue, Uue, Uue, Uue, Uue, Uue, Uue, Uue, Uue, Uue, Uue, Uue, Uue, Uue, Uue, Uue, Uue, Xu
Xu, Uue, Uue, Uue, Uue, Uue, Uue, Uue, Uue, Uue, Uue, Uue, Uue, Urb^Ebn, Uue, Uue, Uue, Uue, Uue, Uue, Uue, Wwg, Uue, Uue, Uue, Uue, Uue, Uue, Uue, Uue, Uue, Uue, Uu^Tf, Uue, Uue, Uu^Vu, Uue, Uue, Uue, Uh, Uue, Xu
Xu, Uue, Uue, Uue, Uue, Uue, Uue, Uue, Uue, Uue, Uue, Uue, Uue, Uue, Uue, Uue, Uue, Uue, Uue, Uh, Uue, Wwg, Uue, Uue, Uu^Tf, Uue, Uue, Uue, Uue, Uue, Uue, Uue, Uue, Uue, Uue, Uue, Uue, Uue, Uue, Uue, Uue, Xu
Xu, Uue, Uue, Uue, Uue, Uue, Uue, Uue, Uue, Uue, Uue, Uue, Uue, Uue, Uue, Uue, Uu^Tf, Uue, Uue, Uue, Uue, Wwg, Uue, Uue, Uue, Uue, Uue, Uue, Uue, Uue, Uue, Uue, Uue, Uue, Uue, Uue, Uue, Uue, Uue, Uue, Uue, Xu
Xu, Uue, Uue, Uue, Uue, Uue, Uue, Uue, Uu^Tf, Uue, Uue, Uue, Uue, Uue, Uue, Uue, Uue, Uue, Uue, Uue, Urb^Ebn, Wwg, Uh, Uue, Uue, Uue, Uue, Uue, Uue, Uue, Uue, Uue, Uue, Uue, Uue, Uue, Uue, Uue, Uue, Uue, Uue, Xu
Xu, Uue, Uh, Uue, Isa, Isa, Isa, Isa, Isa, Isa, Isa, Isa, Isa, Isa, Isa, Isa, Isa, Isa, Isa, Isa, Isa, Isa, Isa, Isa, Isa, Isa, Isa, Isa, Isa, Isa, Isa, Isa, Isa, Isa, Isa, Isa, Isa, Isa, Uue, Uue, Uue, Xu
Xu, Uue, Uue, Uue, Uue, Uue, Uue, Uue, Uue, Uue, Uue, Uue, Uue, Uue, Uue, Uue, Uu^Vu, Uue, Uue, Uue, Uue, Wwg, Uue, Uue, Uue, Uh, Uue, Uue, Uue, Uu^Tf, Uue, Uue, Uue, Uue, Uue, Uue, Uue, Uue, Uue, Uue, Uue, Xu
Xu, Uue, Uue, Uue, Uue, Uh, Uue, Uue, Uue, Uue, Uue, Uue, Uue, Uue, Uue, Uue, Uue, Uue, Uue, Uue, Uue, Wwg, Uue, Uue, Uue, Uue, Uue, Uue, Uu^Vu, Uue, Uue, Uue, Uue, Uue, Uue, Uue, Uue, Uue, Uue, Uue, Uue, Xu
Xu, Uue, Cud, Cud, Uue, Uue, Uue, Uue, Uue, Uue, Uue, Uue, Uue, Uu^Tf, Uue, Uue, Uue, Uue, Uue, Uue, Uue, Wwg, Uue, Uue, Uue, Uue, Uue, Uue, Uh, Uue, Uue, Uue, Uue, Uue, Uue, Uue, Cud, Cud, Uue, Uue, Uue, Xu
Xu, Urb, Cud, Kud, Cud, Uu^Tf, Uue, Urb^Edb, Uh, Uue, Uue, Uue, Uue, Uue, Uue, Uue, Uue, Uue, Uue, Uue, Uue, Wwg, Uue, Uue, Uue, Uue, Uue, Uue, Uue, Uue, Uue, Uue, Uue, Uue, Uue, Uue, Cud, Kud, Cud, Uue, Uue, Xu
Xu, Uue, Uue, Cud, Cud, Uue, Uue, Uue, Uue, Uue, Uue, Uue, Uue, Uue, Uue, Uue, Uue, Uue, Uue, Uue, Uue, Sm^Bsb|, Uue, Uue, Uue, Uue, Uue, Uue, Uue, Uue, Uue, Uh, Uue, Uue, Uu^Tf, Uue, Uue, Cud, Cud, Uue, Uue, Xu
Xu, Uue, Uue, Uue, Uue, Uue, Uue, Uue, Uue, Uue, Uue, Uh, Uue, Uue, Uue, Uue, Uue, Uue, Uue, Uue, Uue, Wwg, Uue, Uue, Uue, Uue, Uu^Tf, Uue, Uue, Uue, Uue, Uue, Uue, Uue, Uue, Uue, Uue, Uue, Uue, Uue, Uue, Xu
Xu, Uue, Uue, Uue, Uue, Uue, Uue, Uue, Uue, Uu^Vu, Uue, Uue, Uue, Uue, Uue, Uue, Uue, Uue, Uu^Tf, Uue, Uue, Wwg, Uue, Uue, Uue, Uue, Uue, Uue, Uue, Uue, Uue, Uue, Uue, Uue, Uh, Uue, Uue, Uue, Uue, Uue, Uue, Xu
Xu, Uue, Uue, Uue, Uue, Uue, Uue, Uue, Uue, Uue, Uu^Tf, Uue, Uue, Uue, Uh, Uue, Uue, Uue, Uue, Uue, Uue, Wwg, Uue, Uue, Uue, Uue, Uue, Uue, Uue, Uue, Uue, Uue, Uue, Uue, Uue, Uue, Uue, Uue, Uue, Uue, Uue, Xu
Xu, Uue, Uu^Tf, Uue, Uue, Uue, Uue, Uue, Uue, Uue, Uue, Uue, Uue, Uue, Uue, Uue, Uue, Uue, Uue, Uue, Uue, Wwg, Uue, Uue, Uue, Uue, Uue, Uue, Uue, Uue, Uue, Uue, Uue, Uu^Vu, Uue, Uue, Uue, Uh, Uue, Uu^Tf, Uue, Xu
Xu, Uue, Uue, Uue, Isa, Isa, Isa, Isa, Isa, Isa, Isa, Isa, Isa, Isa, Isa, Isa, Isa, Isa, Isa, Isa, Isa, Isa, Isa, Isa, Isa, Isa, Isa, Isa, Isa, Isa, Isa, Isa, Isa, Isa, Isa, Isa, Isa, Isa, Uue, Uue, Uue, Xu
Xu, Uue, Uue, Uue, Uue, Uue, Uue, Uue, Uue, Uue, Uue, Uue, Uue, Uue, Uue, Uue, Uue, Uue, Uue, Uue, Uue, Wwg, Uue, Uu^Tf, Uue, Uue, Uue, Urb^Ebn, Uue, Uue, Uue, Uue, Uue, Uue, Uue, Uue, Uue, Uue, Uue, Uue, Uue, Xu
Xu, Uue, Uue, Uue, Uue, Uue, Uue, Uue, Uue, Uue, Uue, Uue, Uue, Uue, Uue, Uu^Tf, Uue, Uue, Uue, Uue, Uh, Wwg, Uue, Uue, Uue, Uue, Uue, Uue, Uue, Uue, Uue, Uue, Uue, Uue, Uue, Uue, Uue, Uue, Uue, Uue, Uue, Xu
Xu, Uue, Uu^Vu, Uue, Uue, Uue, Uue, Uu^Tf, Uue, Uue, Uue, Uue, Uue, Uue, Uue, Uue, Uue, Uue, Uue, Uue, Uue, Wwg, Uue, Uue, Uue, Uue, Uue, Uue, Uue, Uue, Uue, Uue, Uue, Uue, Uue, Uue, Uue, Uue, Uue, Uue, Uue, Xu
Xu, Uue, Uue, Uue, Uue, Uue, Uue, Uue, Uue, Uue, Uue, Uue, Uue, Uue, Uu^Vu, Uue, Uue, Uue, Uue, Uue, Uue, Wwg, Uue, Uh, Uue, Uue, Uue, Uue, Uue, Uue, Uue, Uue, Uue, Uue, Uue, Uue, Uu^Tf, Urb, Uue, Uue, Uue, Xu
Xu, Uue, Uue, Uh, Uue, Uue, Uue, Uue, Uue, Uue, Uue, Uue, Uue, Uue, Uue, Uue, Uue, Uue, Uue, Uue, Uue, Sm^Bsb|, Uue, Uue, Uue, Uue, Uu^Vu, Uue, Uu^Tf, Uue, Uue, Uue, Uue, Uue, Uue, Uue, Uue, Uue, Uue, Uue, Uue, Xu
Xu, Uue, Uue, Uue, Uue, Uue, Uue, Uue, Uue, Uue, Uue, Uue, Uue, Uue, Uue, Uue, Uue, Uue, Uue, Uue, Uu^Tf, Wwg, Uue, Uue, Uue, Uue, Uh, Uue, Uue, Uue, Uue, Uue, Uue, Uue, Uue, Uue, Uue, Uue, Uu^Vu, Uue, Uue, Xu
Xu, Uue, Uue, Uue, Uue, Uue, Uh, Uue, Uue, Uue, Uue, Uue, Uu^Tf, Uue, Uue, Uue, Uue, Uue, Uue, Uue, Uue, Uue, Uue, Uue, Uue, Uue, Uue, Uue, Uue, Uue, Uue, Uue, Uue, Uue, Uue, Uue, Uue, Uue, Uue, Uue, Uue, Xu
Xu, Uue, Uue, Uue, Uue, Uue, Uue, Uue, Uue, Uue, Uue, Uue, Uue, Uue, Uue, Uue, Uue, Uue, Uue, Uue, Uue, Uue, Uue, Uue, Uue, Uue, Uue, Uue, Uue, Uue, Uue, Uue, Uue, Uue, Uue, Uue, Uue, Uue, Uue, Uue, Uue, Xu
Xu, Xu, Xu, Xu, Xu, Xu, Xu, Xu, Xu, Xu, Xu, Xu, Xu, Xu, Xu, Xu, Xu, Xu, Xu, Xu, Xu, Xu, Xu, Xu, Xu, Xu, Xu, Xu, Xu, Xu, Xu, Xu, Xu, Xu, Xu, Xu, Xu, Xu, Xu, Xu, Xu, Xu
