border_size=1
usage=map

Xu, Xu, Xu, Xu, Xu, Xu, Xu, Xu, Xu, Xu, Xu, Xu, Xu, Xu, Xu, Xu, Xu, Xu, Xu, Xu, Xu, Xu, Xu, Xu, Xu, Xu, Xu, Xu, Xu, Xu, Xu, Xu, Xu, Xu, Xu, Xu
Xu, Urb, Urb, Urb, Urb, Urb, Urb, Urb, Urb, Urb, Urb, Urb, Urb, Urb, Urb, Urb, Urb, Urb, Urb, Urb, Urb, Urb, Urb, Urb, Urb, Urb, Urb, Urb, Urb, Urb, Urb, Urb, Urb, Urb, Urb, Xu
Xu, Urb, Urb, Urb, Urb, Urb, Urb, Urb, Urb, Urb, Urb, Urb, Uu^Tf, Urb, Urb, Urb, Urb, Urb, Urb, Urb, Urb, Urb, Urb, Urb, Urb, Uh, Urb, Urb, Urb, Urb, Urb, Urb, Urb, Urb, Urb, Xu
Xu, Urb, Urb, Urb, Uu^Tf, Uh, Urb, Urb, Urb, Urb, Urb, Urb, Urb, Urb, Urb, Urb, Urb, Urb, Urb, Urb, Urb, Urb, Urb, Urb, Urb, Urb, Urb, Urb, Urb, Urb, Chr, Chr, Urb, Urb, Urb, Xu
Xu, Urb, Urb, Urb, Urb, Urb, Urb, Urb, Urb, Urb, Urb, Urb, Urb, Urb, Urb, Urb, Sm, Sm, Sm, Sm, Sm, Urb, Urb, Urb, Urb, Urb, Urb, Urb, Uh, Urb, Chr, Khr, Chr, Uu^Tf, Urb, Xu
Xu, Urb, Urb, Urb, Urb, Urb, Urb, Urb, Uh, Urb, Urb, Urb, Urb, Urb, Urb, Urb, Sm, Sm, Sm, Sm, Sm, Urb, Urb, Urb, Urb, Uu^Tf, Urb, Urb, Urb, Uu^Vu, Urb, Chr, Chr, Urb, Urb, Xu
Xu, Urb, Urb, Urb, Urb, Urb, Urb, Urb, Urb, Urb, Urb, Urb, Urb, Urb, Urb, Urb, Sm, Sm, Sm, Sm, Sm, Urb, Urb, Urb, Urb, Urb, Urb, Urb, Urb, Urb, Urb, Uh, Urb, Urb, Urb, Xu
Xu, Urb, Urb, Urb, Urb, Urb, Urb, Urb, Urb, Uu^Tf, Urb, Urb^Ebn, Urb, Urb, Urb, Urb, Sm, Sm, Sm, Sm, Sm, Urb, Urb, Urb^Ebn, Urb, Urb, Urb, Urb, Urb, Urb, Urb, Urb, Urb, Urb, Urb, Xu
Xu, Urb, Urb, Urb, Urb, Urb, Urb, Urb, Urb, Urb, Urb, Urb, Urb, Urb, Urb, Urb, Sm, Sm, Sm, Sm, Sm, Urb, Urb, Urb, Urb, Urb, Urb, Urb, Urb, Urb, Urb, Urb, Urb, Urb, Urb, Xu
Xu, Urb, Urb, Urb, Urb, Urb, Urb, Urb, Urb, Urb, Urb, Urb, Urb, Urb, Uh, Urb, Sm, Sm, Sm, Sm, Sm, Urb, Urb, Urb, Urb, Urb, Urb, Urb, Urb, Urb, Uu^Tf, Urb, Urb, Urb, Urb, Xu
Xu, Urb, Urb, Urb, Urb, Urb, Urb, Urb, Urb, Urb, Urb, Urb, Urb, Urb, Urb, Urb, Sm^Bsb|, Sm^Bsb|, Sm^Bsb|, Sm^Bsb|, Sm^Bsb|, Urb, Urb, Urb, Urb, Urb, Urb, Urb, Urb, Urb, Urb, Urb, Urb, Urb, Urb, Xu
Xu, Urb, Urb, Urb, Urb, Urb, Urb, Urb, Urb, Urb, Urb, Urb, Urb, Urb, Uu^Tf, Urb, Sm, Sm, Sm, Sm, Sm, Urb, Uu^Vu, Urb, Urb, Urb, Urb, Urb, Urb, Urb, Urb, Urb, Urb, Urb, Urb, Xu
Xu, Urb, Urb, Urb, Urb, Urb, Uu^Tf, Urb, Urb, Urb, Urb, Urb, Urb, Urb, Urb, Urb, Sm, Sm, Sm, Sm, Sm, Urb, Urb, Urb, Urb, Urb, Urb, Urb, Urb, Urb, Urb, Urb, Urb, Urb, Urb, Xu
Xu, Urb, Urb, Urb, Urb, Urb, Urb, Urb, Urb, Urb, Urb, Urb, Urb, Urb, Urb, Urb, Sm, Sm, Sm, Sm, Sm, Urb, Urb, Urb, Urb, Urb, Urb, Urb, Urb, Urb, Urb, Urb, Urb, Urb, Urb, Xu
Xu, Urb, Cud, Cud, Urb, Urb, Urb, Urb, Urb, Urb, Urb, Urb, Urb, Urb, Urb, Urb, Sm, Sm, Sm, Sm, Sm, Urb, Urb, Urb, Urb, Urb, Urb, Uu^Tf, Urb, Urb, Cud, Cud, Urb, Urb, Urb, Xu
Xu, Urb, Cud, Kud, Cud, Urb, Urb, Urb^Edb, Urb, Urb, Urb, Urb, Urb, Urb, Urb, Urb, Sm, Sm, Sm, Sm, Sm, Urb, Urb, Uh, Urb, Urb, Urb, Urb, Urb, Urb, Cud, Kud, Cud, Urb, Urb, Xu
Xu, Urb, Urb, Cud, Cud, Urb, Urb, Urb, Urb, Urb, Urb, Uu^Tf, Urb, Urb, Urb, Urb, Sm, Sm, Sm, Sm, Sm, Urb, Urb, Urb, Urb, Urb, Urb, Urb, Urb, Urb, Urb, Cud, Cud, Urb, Urb, Xu
Xu, Urb, Urb, Uu^Tf, Urb, Urb, Urb, Urb, Urb, Urb, Urb, Urb, Urb, Urb, Urb, Uu^Vu, Sm, Sm, Sm, Sm, Sm, Urb, Urb, Urb, Urb, Urb, Uh, Urb, Urb, Urb, Urb, Urb, Urb, Urb, Urb, Xu
Xu, Urb, Urb, Urb, Urb, Urb, Uh, Urb, Urb, Urb, Urb, Urb, Urb, Urb, Urb, Urb, Sm, Sm, Sm, Sm, Sm, Urb, Urb, Urb, Urb, Urb, Urb, Uu^Vu, Urb, Urb, Urb, Urb, Uu^Tf, Urb, Urb, Xu
Xu, Urb, Urb, Urb, Urb, Urb, Urb, Urb, Urb, Urb, Urb, Urb, Urb, Urb, Urb, Urb, Sm, Sm, Sm, Sm, Sm, Urb, Urb, Urb, Uu^Tf, Urb, Urb, Urb, Urb, Uh, Urb, Urb, Urb, Urb, Urb, Xu
Xu, Urb, Urb, Urb, Urb, Urb, Urb, Urb, Urb, Uh, Urb, Urb, Urb, Urb, Urb, Urb, Sm, Sm, Sm, Sm, Sm, Urb, Urb, Urb, Urb, Urb, Urb, Urb, Urb, Urb, Urb, Urb, Urb, Urb, Urb, Xu
Xu, Urb, Urb, Urb, Urb, Urb, Urb, Urb, Urb, Urb, Urb, Urb, Urb, Urb, Urb, Urb, Sm^Bsb|, Sm^Bsb|, Sm^Bsb|, Sm^Bsb|, Sm^Bsb|, Urb, Urb, Urb, Urb, Urb, Urb, Urb, Urb, Urb, Urb, Urb, Uh, Urb, Urb, Xu
Xu, Urb, Urb, Urb, Urb, Urb, Urb, Urb, Urb, Urb, Urb, Urb, Uh, Urb, Urb, Urb, Sm, Sm, Sm, Sm, Sm, Urb, Urb, Urb, Urb, Urb, Urb, Urb, Urb, Urb, Urb, Urb, Urb, Urb, Urb, Xu
Xu, Urb, Urb, Urb, Urb, Urb, Urb, Urb, Uu^Vu, Urb, Urb, Urb^Ebn, Urb, Urb, Urb, Urb, Sm, Sm, Sm, Sm, Sm, Urb, Urb, Urb^Ebn, Urb, Urb, Urb, Urb, Urb, Uu^Tf, Urb, Urb, Urb, Urb, Urb, Xu
Xu, Urb, Urb, Urb, Urb, Urb, Urb, Urb, Urb, Urb, Urb, Urb, Urb, Urb, Urb, Uh, Sm, Sm, Sm, Sm, Sm, Uu^Tf, Urb, Urb, Urb, Urb, Urb, Urb, Urb, Urb, Urb, Urb, Urb, Urb, Urb, Xu
Xu, Urb, Urb, Urb, Urb, Urb, Urb, Urb, Urb, Urb, Urb, Urb, Urb, Uu^Tf, Urb, Urb, Sm, Sm, Sm, Sm, Sm, Urb, Urb, Urb, Urb, Urb, Urb, Urb, Urb, Urb, Urb, Urb, Uu^Vu, Urb, Urb, Xu
Xu, Urb, Urb, Urb, Urb, Uu^Tf, Urb, Urb, Urb, Urb, Urb, Urb, Urb, Urb, Urb, Urb, Sm, Sm, Sm, Sm, Sm, Urb, Urb, Urb, Urb, Urb, Urb, Urb, Urb, Urb, Urb, Urb, Urb, Urb, Urb, Xu
Xu, Urb, Urb, Urb, Urb, Urb, Urb, Urb, Urb, Urb, Urb, Urb, Urb, Urb, Urb, Urb, Sm, Sm, Sm, Sm, Sm, Urb, Urb, Urb, Urb, Urb, Urb, Urb, Urb, Urb, Urb, Urb, Urb, Urb, Urb, Xu
Xu, Urb, Urb, Urb, Urb, Urb, Urb, Urb, Urb, Urb, Urb, Urb, Urb, Urb, Urb, Urb, Urb, Urb, Urb, Urb, Urb, Uh, Urb, Urb, Urb, Urb, Uu^Tf, Urb, Urb, Urb, Urb, Urb, Urb, Urb, Urb, Xu
Xu, Urb, Urb, Urb, Urb, Urb, Urb, Urb, Urb, Urb, Urb, Urb, Urb, Urb, Urb, Urb, Urb, Urb, Uu^Tf, Urb, Urb, Urb, Urb, Urb, Urb, Urb, Urb, Urb, Urb, Urb, Urb, Urb, Urb, Urb, Urb, Xu
Xu, Urb, Urb, Urb, Urb, Urb, Urb, Urb, Urb, Urb, Urb, Urb, Urb, Urb, Urb, Urb, Urb, Urb, Urb, Urb, Urb, Urb, Urb, Urb, Urb, Urb, Urb, Urb, Urb, Urb, Urb, Urb, Urb, Urb, Urb, Xu
Xu, Xu, Xu, Xu, Xu, Xu, Xu, Xu, Xu, Xu, Xu, Xu, Xu, Xu, Xu, Xu, Xu, Xu, Xu, Xu, Xu, Xu, Xu, Xu, Xu, Xu, Xu, Xu, Xu, Xu, Xu, Xu, Xu, Xu, Xu, Xu
