border_size=1
usage=map

Xu, Xu, Xu, Xu, Xu, Xu, Xu, Xu, Xu, Xu, Xu, Xu, Xu, Xu, Xu, Xu, Xu, Xu, Xu, Xu, Xu, Xu, Xu, Xu, Xu, Xu, Xu, Xu, Xu, Xu, Xu, Xu, Xu, Xu, Xu, Xu, Xu, Xu
Xu, Uue, Uue, Uue, Uue, Uue, Uue, Uue, Uue, Uue, Uue, Uue, Uue, Uue, Uue, Uue, Uue, Uue, Uue, Uue, Uue, Uue, Uue, Uue, Uue, Uue, Uue, Uue, Uue, Uue, Uue, Uue, Uue, Uue, Uue, Uue, Uue, Xu
Xu, Uue, Uue, Uue, Uue, Uue, Uue, Uue, Uue, Uue, Uue, Uue, Uue, Uue, Uue, Uue, Uue, Uh, Uue, Uue, Uue, Uue, Uue, Uue, Uue, Uue, Uue, Uue, Uue, Uue, Uue, Uue, Uue, Uue, Uu^Tf, Uue, Uue, Xu
Xu, Uue, Uue, Uue, Uue, Uue, Uue, Uue, Uue, Uue, Uue, Uu^Vu, Xoc, Uue, Uue, Uue, Uue, Uue, Uue, Uue, Uue, Uue, Uue, Uue, Uue, Xoc, Uu^Tf, Uue, Uue, Uue, Uue, Uue, Uue, Uue, Uue, Uue, Uue, Xu
Xu, Uue, Uue, Uue, Uue, Uue, Uue, Uue, Uue, Uue, Uue, Uue, Xoc, Uue, Uue, Uue, Uue, Uue, Uu^Tf, Uue, Uh, Uue, Uue, Uu^Vu, Uue, Xoc, Uue, Uue, Uue, Uue, Uue, Uue, Uue, Urb, Uue, Uue, Uue, Xu
Xu, Uue, Uue, Uue, Uue, Uue, Uue, Uue, Uue, Uue, Uu^Tf, Uue, Xoc, Uue, Uue, Uue, Uue, Uue, Uue, Uue, Uue, Uue, Uue, Uue, Uue, Xoc, Uue, Uue, Uue, Uue, Uue, Uue, Uue, Uue, Uue, Uu^Vu, Uue, Xu
Xu, Uue, Uu^Tf, Uue, Uue, Uue, Uue, Uue, Uue, Uue, Uue, Urb^Ebn, Xoc, Uue, Uue, Uue, Uue, Uue, Uue, Uue, Uue, Uue, Uue, Uh, Uue, Xoc, Uue, Uue, Uue, Uue, Uue, Uue, Uue, Uue, Uue, Uue, Uue, Xu
Xu, Uue, Uue, Uh, Uue, Uue, Uue, Uue, Uue, Uue, Uue, Uue, Xoc, Uue, Uue, Uue, Uue, Uue, Uue, Uue, Uue, Uue, Uue, Uue, Uue, Xoc, Uue, Uue, Uue, Uue, Uue, Uu^Tf, Uue, Uue, Uue, Uue, Uue, Xu
Xu, Uue, Uue, Uue, Uue, Uue, Uue, Uue, Uue, Uue, Uue, Uue, Xoc, Uue, Uue, Uue, Uue, Uue, Urb^Ebn, Uue, Uue, Uue, Uue, Uu^Tf, Uue, Xoc, Uh, Uue, Uue, Uue, Uue, Uue, Uue, Uue, Uue, Uue, Uue, Xu
Xu, Uue, Uue, Xoc, Xoc, Xoc, Xoc, Xoc, Xoc, Xoc, Xoc, Xoc, Uue, Xoc, Xoc, Xoc, Xoc, Xoc, Xoc, Uue, Xoc, Xoc, Xoc, Xoc, Xoc, Uue, Xoc, Xoc, Xoc, Xoc, Xoc, Xoc, Xoc, Xoc, Xoc, Uue, Uue, Xu
Xu, Uue, Uue, Uue, Uue, Uue, Uue, Uu^Tf, Uue, Uue, Uue, Uue, Xoc, Uue, Uue, Uue, Uu^Vu, Uue, Uue, Uue, Uue, Uue, Uue, Uue, Uue, Xoc, Uue, Uue, Uue, Uh, Uue, Uue, Uue, Uue, Uue, Uue, Uue, Xu
Xu, Uue, Uue, Uue, Uue, Uue, Uue, Uue, Uue, Uh, Uue, Uue, Xoc, Uue, Uue, Uue, Uue, Uue, Uue, Uue, Uue, Uue, Uue, Uue, Uue, Xoc, Uue, Uue, Uu^Vu, Uue, Uue, Uue, Uue, Uue, Uue, Uue, Uue, Xu
Xu, Uue, Cud, Cud, Uue, Uue, Uue, Uue, Uue, Uue, Uue, Uue, Xoc, Uue, Uue, Uue, Uue, Isa, Isa, Isa, Isa, Isa, Uue, Uue, Uue, Xoc, Uue, Uue, Uu^Tf, Uue, Uue, Uue, Cud, Cud, Uue, Uue, Uue, Xu
Xu, Urb, Cud, Kud, Cud, Uue, Uue, Urb^Edb, Uue, Uue, Uue, Uue, Xoc, Uue, Uue, Uue, Uue, Isa, Isa, Isa, Isa, Isa, Uue, Uue, Uue, Xoc, Uue, Uue, Uue, Uue, Uue, Uue, Cud, Kud, Cud, Uue, Uue, Xu
Xu, Uue, Uue, Cud, Cud, Uue, Uue, Uue, Uue, Uue, Uue, Uue, Uu^Tf, Uue, Uue, Uue, Uue, Isa, Isa, Isa, Isa, Isa, Uue, Uue, Uue, Uue, Uue, Uue, Uue, Uue, Uue, Uue, Uue, Cud, Cud, Uh, Uue, Xu
Xu, Uue, Uue, Uue, Uu^Tf, Uue, Uue, Uue, Uue, Uue, Uue, Uue, Xoc, Uue, Uue, Uh, Uue, Isa, Isa, Isa, Isa, Isa, Uue, Uue, Uue, Xoc, Uue, Uue, Uue, Uue, Uue, Uue, Uue, Uue, Uue, Uue, Uue, Xu
Xu, Uue, Uue, Uue, Uue, Uue, Uue, Uue, Uue, Uu^Vu, Uue, Uue, Xoc, Uue, Uue, Uue, Uue, Isa, Isa, Isa, Isa, Isa, Uue, Uue, Uue, Xoc, Uue, Uue, Uue, Uue, Uue, Uue, Uue, Uu^Tf, Uue, Uue, Uue, Xu
Xu, Uue, Uue, Uue, Uue, Uue, Uue, Uue, Uue, Uue, Uue, Uue, Xoc, Uue, Uue, Uue, Uue, Uue, Uh, Uue, Uue, Uu^Vu, Uue, Uue, Uue, Xoc, Uue, Uue, Uue, Uue, Uue, Uue, Uue, Uue, Uue, Uue, Uue, Xu
Xu, Uue, Uue, Xoc, Xoc, Xoc, Xoc, Xoc, Xoc, Xoc, Xoc, Xoc, Uue, Xoc, Xoc, Xoc, Xoc, Xoc, Xoc, Uue, Xoc, Xoc, Xoc, Xoc, Xoc, Uue, Xoc, Xoc, Xoc, Xoc, Xoc, Xoc, Xoc, Xoc, Xoc, Uue, Uue, Xu
Xu, Uue, Uue, Uue, Uue, Uue, Uue, Uue, Uue, Uu^Tf, Uue, Uue, Xoc, Uue, Uue, Uue, Uue, Uue, Uue, Uue, Uue, Uh, Uue, Uue, Uue, Xoc, Uue, Uue, Uue, Uue, Uue, Uue, Uue, Uue, Uue, Uue, Uue, Xu
Xu, Uue, Uue, Uue, Uue, Uue, Uue, Uue, Uue, Uue, Uue, Uue, Xoc, Uue, Uue, Uue, Uue, Uue, Uue, Uue, Uue, Uue, Uue, Uue, Urb^Ebn, Xoc, Uue, Uue, Uue, Uue, Uue, Uue, Uue, Uue, Uue, Uue, Uue, Xu
Xu, Uue, Uue, Uue, Uue, Uue, Uue, Uue, Uue, Uue, Uue, Uue, Xoc, Uue, Uue, Uue, Uue, Uue, Uue, Uue, Uue, Uue, Uue, Uue, Uh, Xoc, Uue, Uue, Uue, Uue, Uu^Tf, Uue, Uue, Uue, Uue, Uue, Uue, Xu
Xu, Uue, Uu^Vu, Uue, Uh, Uue, Uue, Uue, Uue, Uue, Uue, Uue, Xoc, Uue, Uue, Uue, Uue, Uue, Uue, Uue, Uue, Uue, Uu^Tf, Uue, Uue, Xoc, Uue, Uue, Uue, Uue, Uue, Uue, Uue, Urb, Uue, Uue, Uue, Xu
Xu, Uue, Uue, Uue, Uue, Uue, Uue, Uue, Uue, Uue, Uue, Uue, Xoc, Uue, Uu^Tf, Uue, Uue, Uue, Uue, Uue, Uue, Uue, Uue, Uue, Uue, Xoc, Uue, Uh, Uue, Uue, Uue, Uue, Uue, Uue, Uue, Uue, Uue, Xu
Xu, Uue, Uue, Uue, Uue, Uue, Uu^Tf, Uh, Uue, Uue, Uue, Uue, Xoc, Uue, Uue, Uue, Uue, Uue, Uue, Uue, Uue, Uue, Uue, Uue, Uue, Xoc, Uu^Vu, Uue, Uue, Uue, Uue, Uue, Uue, Uue, Uue, Uue, Uue, Xu
Xu, Uue, Uue, Uue, Uue, Uue, Uue, Uue, Uue, Uue, Uue, Uue, Uue, Uue, Uue, Uue, Uue, Uue, Uue, Uue, Uue, Uue, Uue, Uue, Uue, Uue, Uue, Uue, Uue, Uue, Uh, Uue, Uue, Uue, Uue, Uu^Tf, Uue, Xu
Xu, Uue, Uue, Uue, Uue, Uue, Uue, Uue, Uue, Uue, Uue, Uue, Uue, Uue, Uue, Uue, Uue, Uue, Uue, Uue, Uue, Uue, Uue, Uue, Uue, Uue, Uue, Uue, Uue, Uue, Uue, Uue, Uue, Uue, Uue, Uue, Uue, Xu
Xu, Xu, Xu, Xu, Xu, Xu, Xu, Xu, Xu, Xu, Xu, Xu, Xu, Xu, Xu, Xu, Xu, Xu, Xu, Xu, Xu, Xu, Xu, Xu, Xu, Xu, Xu, Xu, Xu, Xu, Xu, Xu, Xu, Xu, Xu, Xu, Xu, Xu
