border_size=1
usage=map

Xu, Xu, Xu, Xu, Xu, Xu, Xu, Xu, Xu, Xu, Xu, Xu, Xu, Xu, Xu, Xu, Xu, Xu, Xu, Xu, Xu, Xu, Xu, Xu, Xu, Xu, Xu, Xu, Xu, Xu, Xu, Xu, Xu, Xu, Xu, Xu, Xu, Xu, Xu, Xu, Xu, Xu
Xu, Uue, Uue, Uue, Uue, Uue, Uue, Uue, Uue, Uue, Uue, Uue, Uue, Uue, Uue, Uue, Uue, Uue, Uue, Uue, Uue, Uue, Uue, Uue, Uue, Uue, Uue, Uue, Uue, Uue, Uue, Uue, Uue, Uue, Uue, Uue, Uue, Uue, Uue, Uue, Uue, Xu
Xu, Uue, Uue, Uue, Uu^Tf, Uue, Uue, Uue, Uue, Uue, Uue, Uu^Vu, Uue, Uue, Uue, Uue, Uue, Uue, Uue, Uue, Uue, Uue, Uue, Uue, Uue, Uue, Uue, Uue, Uue, Uue, Uue, Uue, Uue, Uue, Uue, Uue, Uue, Uue, Uue, Uue, Uue, Xu
Xu, Uue, Uue, Uue, Uue, Uue, Uue, Uue, Uue, Uue, Uue, Uue, Uue, Uue, Uue, Uue, Uue, Uue, Uue, Uue, Uue, Rrc, Uue, Uu^Vu, Uh, Uue, Uue, Uue, Uue, Uue, Uue, Uue, Uue, Uu^Tf, Uue, Uue, Chr, Chr, Uue, Uue, Uue, Xu
Xu, Uue, Uue, Uue, Uh, Uue, Uue, Uue, Uue, Uue, Uue, Uue, Uue, Uue, Uue, Uue, Uue, Uue, Uue, Uue, Uue, Rrc, Uue, Uue, Uue, Uu^Tf, Uue, Uue, Uue, Uue, Uue, Uue, Uue, Uue, Uue, Uu^Vu, Chr, Khr, Chr, Uue, Uue, Xu
Xu, Uue, Uue, Uue, Uue, Uue, Urb^Vhc, Uue, Uue, Uue, Uue, Uue, Uue, Urb^Vhcr, Uue, Uue, Uue, Uu^Tf, Uue, Uue, Urb^Vhc, Rrc, Uue, Uue, Uue, Xoc, Xoc, Xoc, Xoc, Xoc, Xoc, Xoc, Xoc, Xoc, Xoc, Xoc, Xoc, Chr, Chr, Uue, Uue, Xu
Xu, Uue, Uue, Uue, Uue, Uue, Uue, Uh, Uue, Uu^Tf, Uue, Uue, Uue, Uue, Uue, Uue, Uue, Uue, Uue, Uue, Uue, Rrc, Uue, Uue, Uue, Uue, Uue, Uue, Uue, Uue, Uue, Uue, Uue, Uue, Uue, Uue, Uue, Uue, Uue, Uue, Uue, Xu
Xu, Uue, Uue, Uue, Uue, Uue, Uue, Uue, Uue, Uue, Uue, Uue, Uue, Urb^Ebn, Uue, Uue, Uue, Uue, Uue, Uue, Uue, Rrc, Uue, Uue, Uue, Uue, Uue, Urb^Ebn, Uue, Uue, Uh, Uue, Uue, Uue, Uue, Uue, Uue, Uue, Uu^Tf, Uue, Uue, Xu
Xu, Uue, Uue, Uue, Uu^Vu, Uue, Uue, Uue, Uue, Uue, Uh, Uue, Uue, Uue, Uue, Uue, Uue, Uue, Uue, Uue, Uue, Rrc, Uue, Uue, Uue, Uue, Uue, Uue, Uue, Uue, Uu^Tf, Uue, Uue, Uue, Uue, Uue, Uue, Uue, Uue, Uue, Uue, Xu
Xu, Uue, Uue, Uue, Uue, Uue, Uue, Uue, Uue, Uue, Uue, Uue, Uue, Uue, Uue, Uue, Uu^Vu, Uue, Uue, Uue, Uue, Rrc, Uu^Tf, Uue, Uue, Uue, Uue, Uue, Uue, Uue, Uue, Uue, Uue, Uh, Uue, Uue, Uue, Uue, Uue, Uue, Uue, Xu
Xu, Uue, Uue, Uue, Uue, Uue, Urb^Vhcr, Uue, Uue, Uue, Uue, Uue, Uue, Urb^Vhc, Uu^Tf, Uue, Uue, Uue, Uue, Uue, Urb^Vhcr, Rrc, Uue, Uue, Uue, Uue, Uue, Urb^Vhc, Uu^Vu, Uue, Uue, Uue, Uue, Uue, Urb^Vhcr, Uue, Uue, Uue, Uue, Uue, Uue, Xu
Xu, Uue, Uue, Uue, Uue, Uue, Uu^Tf, Uue, Uue, Uue, Uue, Uue, Uue, Uue, Uue, Uue, Uue, Uue, Uue, Uue, Uue, Rrc, Uue, Uue, Uue, Uue, Uue, Uue, Uue, Uue, Uue, Uue, Uue, Uue, Uue, Uue, Uh, Uue, Uue, Uue, Uue, Xu
Xu, Uue, Uue, Uue, Uue, Uue, Uue, Uue, Uue, Uue, Uue, Uue, Uue, Uue, Uue, Uue, Uh, Uue, Uue, Uue, Uue, Rrc, Uue, Uue, Uue, Uue, Uue, Uue, Uue, Uue, Uue, Uue, Uue, Uue, Uue, Uu^Tf, Uue, Uue, Uue, Uue, Uue, Xu
Xu, Uue, Uue, Uue, Uue, Uue, Uue, Uue, Uue, Uue, Uue, Uue, Uue, Uue, Uue, Uue, Uue, Uue, Uue, Uue, Uue, Rrc, Uue, Uue, Uue, Uue, Uue, Uu^Tf, Uue, Uue, Uue, Uue, Uue, Uue, Uue, Uue, Uue, Uue, Uue, Uh, Uue, Xu
Xu, Uue, Cud, Cud, Uue, Uue, Uue, Uue, Uue, Uue, Uue, Uue, Uue, Uue, Uue, Uue, Uue, Uue, Uue, Uh, Uue, Rrc, Uue, Uue, Uue, Uue, Uue, Uue, Uue, Uue, Uue, Uue, Uue, Uue, Uue, Uue, Cud, Cud, Uue, Uue, Uue, Xu
Xu, Urb, Cud, Kud, Cud, Uue, Urb^Vhc, Urb^Edb, Uue, Uu^Vu, Uue, Uu^Tf, Uue, Urb^Vhcr, Uue, Uue, Uue, Uue, Uue, Uue, Urb^Vhc, Rrc, Uue, Uue, Uue, Uue, Uue, Urb^Vhcr, Uue, Uue, Uue, Uue, Uue, Uue, Urb^Vhc, Uue, Cud, Kud, Cud, Uue, Uue, Xu
Xu, Uue, Uue, Cud, Cud, Rrc, Rrc, Rrc, Rrc, Rrc, Rrc, Rrc, Rrc, Rrc, Rrc, Rrc, Rrc, Rrc, Rrc, Rrc, Rrc, Rrc, Rrc, Rrc, Rrc, Rrc, Rrc, Rrc, Rrc, Rrc, Rrc, Rrc, Rrc, Rrc, Rrc, Rrc, Rrc, Cud, Cud, Uue, Uue, Xu
Xu, Uue, Uh, Uue, Uue, Uue, Uue, Uue, Uue, Uue, Uue, Uue, Uue, Uue, Uue, Uue, Uue, Uue, Uue, Uue, Uue, Rrc, Uue, Uue, Uue, Uue, Uue, Uue, Uue, Uue, Uue, Uue, Uu^Tf, Uu^Vu, Uue, Uue, Uue, Uue, Uue, Uue, Uue, Xu
Xu, Uue, Uue, Uue, Uue, Uue, Uue, Uue, Uue, Uue, Uue, Uue, Uue, Uue, Uue, Uue, Uue, Uue, Uue, Uue, Uue, Rrc, Uue, Uue, Uu^Tf, Uh, Uue, Uue, Uue, Uue, Uue, Uue, Uue, Uue, Uue, Uue, Uue, Uue, Uue, Uue, Uue, Xu
Xu, Uue, Uue, Uue, Uue, Uh, Uue, Uue, Uue, Uue, Uue, Uue, Uue, Uue, Uue, Uue, Uu^Tf, Uue, Uue, Uue, Uue, Rrc, Uue, Uue, Uue, Uue, Uue, Uue, Uue, Uue, Uue, Uue, Uue, Uue, Uue, Uue, Uue, Uue, Uue, Uue, Uue, Xu
Xu, Uue, Uue, Uue, Uue, Uue, Urb^Vhcr, Uue, Uu^Tf, Uue, Uue, Uue, Uue, Urb^Vhc, Uue, Uue, Uue, Uue, Uue, Uue, Urb^Vhcr, Rrc, Uue, Uue, Uue, Uue, Uue, Urb^Vhc, Uh, Uue, Uue, Uue, Uue, Uue, Urb^Vhcr, Uue, Uue, Uue, Uue, Uue, Uue, Xu
Xu, Uue, Uu^Vu, Uue, Uue, Uue, Uue, Uue, Uh, Uue, Uue, Uue, Uue, Uue, Uue, Uue, Uue, Uue, Uue, Uue, Uue, Rrc, Uue, Uue, Uue, Uue, Uue, Uue, Uue, Uue, Uue, Uue, Uue, Uue, Uue, Uue, Uue, Uu^Tf, Uue, Uue, Uue, Xu
Xu, Uue, Uue, Uue, Uue, Uue, Uue, Uue, Uue, Uue, Uue, Uue, Uue, Uue, Uu^Vu, Uue, Uue, Uue, Uue, Uue, Uue, Rrc, Uue, Uue, Uue, Uue, Uue, Uue, Uue, Uu^Tf, Uue, Uh, Uue, Uue, Uue, Uue, Uue, Uue, Uue, Uue, Uue, Xu
Xu, Uue, Uue, Uue, Uue, Uue, Uue, Uue, Uue, Uue, Uue, Uh, Uue, Urb^Ebn, Uue, Uue, Uue, Uue, Uue, Uue, Uue, Rrc, Uue, Uue, Uue, Uue, Uu^Vu, Urb^Ebn, Uue, Uue, Uue, Uue, Uue, Uue, Uue, Uue, Uue, Uue, Uue, Uue, Uue, Xu
Xu, Uue, Uue, Uue, Uue, Uue, Uue, Uue, Uue, Uue, Uue, Uue, Uue, Uu^Tf, Uue, Uue, Uue, Uue, Uue, Uue, Uue, Rrc, Uue, Uue, Uue, Uue, Uue, Uue, Uue, Uue, Uue, Uue, Uue, Uue, Uh, Uue, Uue, Uue, Uu^Vu, Uue, Uue, Xu
Xu, Uue, Uue, Uue, Uue, Uu^Tf, Urb^Vhc, Uue, Uue, Uue, Uue, Uue, Uue, Urb^Vhcr, Uh, Uue, Uue, Uue, Uue, Uue, Urb^Vhc, Rrc, Uue, Uue, Uue, Uue, Uue, Urb^Vhcr, Uue, Uue, Uue, Uue, Uue, Uue, Urb^Vhc, Uue, Uue, Uue, Uue, Uue, Uue, Xu
Xu, Uue, Uue, Uue, Uue, Uue, Uue, Uue, Uue, Uue, Uue, Uue, Uue, Uue, Uue, Uue, Uue, Uue, Uue, Uue, Uue, Rrc, Uue, Uue, Uue, Uue, Uue, Uue, Uue, Uue, Uue, Uue, Uue, Uue, Uu^Tf, Uue, Uue, Urb, Uue, Uue, Uue, Xu
Xu, Uue, Uue, Uue, Uue, Uue, Uue, Uue, Uue, Uue, Uue, Uue, Uue, Uue, Uue, Uue, Uue, Uh, Uue, Uue, Uue, Rrc, Uue, Uue, Uue, Uue, Uu^Tf, Uue, Uue, Uue, Uue, Uue, Uue, Uue, Uue, Uue, Uue, Uue, Uue, Uue, Uue, Xu
Xu, Uue, Uue, Uue, Uue, Uue, Uue, Uu^Vu, Uue, Uue, Uue, Uue, Uue, Uue, Uue, Uue, Uue, Uue, Uu^Tf, Uue, Uue, Rrc, Uue, Uue, Uue, Uue, Uue, Uue, Uue, Uue, Uue, Uue, Uue, Uue, Uue, Uue, Uue, Uue, Uue, Uue, Uue, Xu
Xu, Uue, Uue, Uue, Uue, Uue, Uue, Uue, Uue, Uue, Uu^Tf, Uue, Uue, Uue, Uue, Uue, Uue, Uue, Uue, Uu^Vu, Uh, Uue, Uue, Uue, Uue, Uue, Uue, Uue, Uue, Uue, Uue, Uue, Uue, Uue, Uue, Uue, Uue, Uue, Uue, Uue, Uue, Xu
Xu, Uue, Uue, Uue, Uue, Uue, Uue, Uue, Uue, Uue, Uue, Uue, Uue, Uue, Uue, Uue, Uue, Uue, Uue, Uue, Uue, Uue, Uue, Uue, Uue, Uue, Uue, Uue, Uue, Uue, Uue, Uue, Uue, Uue, Uue, Uue, Uue, Uue, Uue, Uue, Uue, Xu
Xu, Xu, Xu, Xu, Xu, Xu, Xu, Xu, Xu, Xu, Xu, Xu, Xu, Xu, Xu, Xu, Xu, Xu, Xu, Xu, Xu, Xu, Xu, Xu, Xu, Xu, Xu, Xu, Xu, Xu, Xu, Xu, Xu, Xu, Xu, Xu, Xu, Xu, Xu, Xu, Xu, Xu
