border_size=1
usage=map

Xu, Xu, Xu, Xu, Xu, Xu, Xu, Xu, Xu, Xu, Xu, Xu, Xu, Xu, Xu, Xu, Xu, Xu, Xu, Xu, Xu, Xu, Xu, Xu, Xu, Xu, Xu, Xu, Xu, Xu, Xu, Xu, Xu, Xu, Xu, Xu, Xu, Xu, Xu, Xu
Xu, Urb, Urb, Urb, Urb, Urb, Urb, Urb, Urb, Urb, Urb, Urb, Urb, Urb, Urb, Urb, Urb, Urb, Urb, Urb, Urb, Urb, Urb, Urb, Urb, Urb, Urb, Urb, Urb, Urb, Urb, Urb, Urb, Urb, Urb, Urb, Urb, Urb, Urb, Xu
Xu, Urb, Urb, Urb, Urb, Urb, Urb, Urb, Urb, Urb, Urb, Urb, Urb, Urb, Urb, Urb, Urb, Urb, Urb, Urb, Uh, Urb, Urb, Urb, Urb, Urb, Urb, Urb, Urb, Uu^Vu, Urb, Urb, Urb, Uu^Tf, Urb, Urb, Urb, Urb, Urb, Xu
Xu, Urb, Urb, Urb, Urb, Urb, Urb, Urb, Urb, Urb, Urb, Urb, Urb, Urb, Urb, Urb, Urb, Urb, Urb, Urb, Urb, Urb, Urb, Urb, Urb, Uu^Tf, Urb, Urb, Urb, Urb, Urb, Urb, Urb, Urb, Chr, Chr, Urb, Urb, Urb, Xu
Xu, Urb, Urb, Urb, Urb, Urb, Urb, Urb, Urb, Urb, Urb, Urb, Urb, Urb, Urb, Urb, Urb, Uu^Tf, Urb, Urb, Urb, Urb, Urb, Uh, Urb, Urb, Urb, Urb, Urb, Urb, Urb, Urb, Urb, Urb, Chr, Khr, Chr, Urb, Urb, Xu
Xu, Urb, Urb, Uh, Urb, Urb, Urb, Urb, Qxe, Qxe, Qxe, Qxe, Urb, Urb, Urb, Urb, Qxe, Qxe, Qxe, Qxe, Urb, Urb, Urb, Urb, Qxe, Qxe, Qxe, Qxe, Urb, Urb, Urb, Urb, Qxe, Qxe, Qxe, Chr, Chr, Urb, Urb, Xu
Xu, Urb, Urb, Urb, Urb, Urb, Urb, Urb, Urb, Urb, Urb, Urb, Urb, Urb, Urb, Urb, Urb, Urb, Urb, Urb, Urb, Urb, Urb, Urb, Urb, Urb, Uh, Urb, Urb, Urb, Urb, Urb, Urb, Urb, Urb, Urb, Urb, Urb, Urb, Xu
Xu, Urb, Urb, Urb, Urb, Urb, Uh, Urb, Urb, Urb, Uu^Vu, Urb, Urb^Ebn, Urb, Urb, Urb, Urb, Urb, Urb, Urb, Urb, Urb, Urb, Urb, Urb, Urb, Urb, Urb, Urb, Urb, Uu^Tf, Urb, Urb, Urb, Urb, Urb, Urb, Urb, Urb, Xu
Xu, Urb, Urb, Urb, Urb, Urb, Urb, Urb, Urb, Urb, Urb, Urb, Urb, Urb, Urb, Urb, Urb, Urb, Urb, Urb, Urb, Urb, Uu^Tf, Urb, Urb, Urb, Urb, Urb, Urb, Uh, Urb, Urb, Urb, Urb, Urb, Urb, Urb, Urb, Urb, Xu
Xu, Urb, Urb, Urb, Urb, Urb, Urb, Urb, Urb, Uh, Urb, Urb, Urb, Urb, Uu^Tf, Urb, Urb, Urb, Urb, Urb^Ebn, Urb, Urb, Urb, Urb, Urb, Urb, Urb, Urb, Urb, Urb, Urb, Urb, Urb, Urb, Uu^Vu, Urb, Urb, Urb, Urb, Xu
Xu, Urb, Urb, Urb, Urb, Urb, Uu^Tf, Urb, Urb, Urb, Urb, Urb, Urb, Urb, Urb, Urb, Urb, Urb, Urb, Urb, Urb, Urb, Urb, Urb, Urb, Urb, Urb, Urb, Urb, Urb, Urb, Urb, Uh, Urb, Urb, Urb, Urb, Urb, Urb, Xu
Xu, Urb, Urb, Urb, Urb, Urb, Urb, Urb, Qxe, Qxe, Qxe, Qxe, Uh, Urb, Urb, Urb, Qxe, Qxe, Qxe, Qxe, Urb, Urb, Urb, Urb, Qxe, Qxe, Qxe, Qxe, Urb, Urb, Urb, Urb, Qxe, Qxe, Qxe, Uu^Tf, Urb, Urb, Urb, Xu
Xu, Urb, Urb, Urb, Urb, Urb, Urb, Urb, Urb, Urb, Urb, Urb, Urb, Urb, Urb, Urb, Urb, Urb, Urb, Urb, Urb, Urb, Urb, Urb, Urb, Urb, Urb, Uu^Tf, Urb, Urb, Urb, Urb, Urb, Urb, Urb, Uh, Urb, Urb, Urb, Xu
Xu, Urb, Urb, Uu^Vu, Urb, Urb, Urb, Urb, Urb, Urb, Urb, Urb, Urb, Urb, Urb, Uh, Urb, Urb, Urb, Uu^Tf, Urb, Urb, Urb, Urb, Urb, Urb, Urb, Urb, Urb, Urb, Urb, Urb, Urb, Urb, Urb, Urb, Urb, Urb, Urb, Xu
Xu, Urb, Cud, Cud, Urb, Urb, Urb, Urb, Urb, Urb, Urb, Uu^Tf, Urb, Urb, Urb, Uu^Vu, Urb, Urb, Urb, Urb, Urb, Urb, Urb, Urb, Urb, Urb, Urb, Urb, Urb, Urb, Urb, Urb, Urb, Urb, Cud, Cud, Urb, Urb, Urb, Xu
Xu, Urb, Cud, Kud, Cud, Urb, Urb, Urb^Edb, Urb, Urb, Urb, Urb, Urb, Urb, Urb, Urb, Urb, Urb, Uh, Urb, Urb, Urb, Urb, Urb, Urb, Urb, Urb, Uu^Vu, Urb, Urb, Urb, Urb, Urb, Urb, Cud, Kud, Cud, Urb, Urb, Xu
Xu, Urb, Urb, Cud, Cud, Urb, Urb, Chr, Chr, Chr, Chr, Urb, Urb, Urb, Chr, Chr, Chr, Chr, Urb, Urb, Urb, Chr, Chr, Chr, Chr, Urb, Urb, Urb, Chr, Chr, Chr, Chr, Uu^Tf, Urb, Urb, Cud, Cud, Urb, Urb, Xu
Xu, Urb, Urb, Urb, Urb, Urb, Urb, Urb, Qxe, Qxe, Qxe, Qxe, Urb, Urb, Urb, Urb, Qxe, Qxe, Qxe, Qxe, Urb, Uh, Urb, Urb, Qxe, Qxe, Qxe, Qxe, Urb, Urb, Urb, Urb, Qxe, Qxe, Qxe, Urb, Urb, Urb, Urb, Xu
Xu, Urb, Urb, Urb, Urb, Urb, Urb, Urb, Urb, Urb, Urb, Urb, Urb, Urb, Urb, Urb, Uu^Tf, Urb, Urb, Urb, Urb, Urb, Urb, Urb, Urb, Urb, Urb, Urb, Urb, Urb, Urb, Urb, Urb, Urb, Urb, Urb, Urb, Urb, Urb, Xu
Xu, Urb, Urb, Urb, Urb, Urb, Urb, Urb, Uu^Tf, Urb, Urb, Urb, Urb, Urb, Urb, Urb, Urb, Urb, Urb, Urb, Urb, Urb, Urb, Urb, Uh, Urb, Urb, Urb, Urb, Urb, Urb, Urb, Urb, Urb, Urb, Urb, Urb, Urb, Urb, Xu
Xu, Urb, Urb, Urb, Uh, Urb, Urb, Urb, Uu^Vu, Urb, Urb, Urb, Urb, Urb, Urb, Urb, Urb, Urb, Urb, Urb, Urb, Urb, Urb, Urb, Urb, Urb, Urb, Urb, Urb, Urb, Urb, Urb, Urb, Urb, Urb, Urb, Urb, Uu^Tf, Urb, Xu
Xu, Urb, Urb, Urb, Urb, Urb, Urb, Urb, Urb, Urb, Urb, Urb, Urb, Urb, Urb, Urb, Urb, Urb, Urb, Urb, Uu^Vu, Urb, Urb, Urb, Urb, Urb, Urb, Uh, Urb, Uu^Tf, Urb, Urb, Urb, Urb, Urb, Urb, Urb, Urb, Urb, Xu
Xu, Urb, Urb, Urb, Urb, Urb, Urb, Uh, Urb, Urb, Urb, Urb, Urb, Urb, Urb, Urb, Urb, Urb, Urb, Urb, Urb, Uu^Tf, Urb, Urb, Urb, Urb, Urb, Urb, Urb, Urb, Urb, Urb, Uu^Vu, Urb, Urb, Urb, Urb, Urb, Urb, Xu
Xu, Urb, Urb, Urb, Urb, Urb, Urb, Urb, Qxe, Qxe, Qxe, Qxe, Urb, Uu^Tf, Urb, Urb, Qxe, Qxe, Qxe, Qxe, Urb, Urb, Urb, Urb, Qxe, Urb^Ebn, Qxe, Qxe, Urb, Urb, Uh, Urb, Qxe, Qxe, Qxe, Urb, Urb, Urb, Urb, Xu
Xu, Urb, Urb, Urb, Urb, Uu^Tf, Urb, Urb, Urb, Urb, Uh, Urb, Urb, Urb, Urb, Urb, Urb, Urb, Urb, Urb, Urb, Urb, Urb, Urb, Urb, Urb, Urb, Urb, Urb, Urb, Urb, Urb, Urb, Urb, Urb, Urb, Urb, Urb, Urb, Xu
Xu, Urb, Urb, Urb, Urb, Urb, Urb, Urb, Urb, Urb, Urb, Urb, Urb, Urb, Urb, Urb, Urb, Urb, Urb, Urb, Urb, Urb, Urb, Urb, Urb, Urb, Urb, Urb, Urb, Urb, Urb, Urb, Urb, Uh, Uu^Tf, Urb, Urb, Urb, Urb, Xu
Xu, Urb, Urb, Urb, Urb, Urb, Urb, Urb, Urb, Urb, Urb, Urb, Urb, Uh, Urb, Urb, Urb, Urb, Urb, Urb, Urb, Urb, Urb, Urb, Urb, Urb, Uu^Tf, Urb, Urb, Urb, Urb, Urb, Urb, Urb, Urb, Urb, Urb, Urb, Urb, Xu
Xu, Urb, Urb, Urb, Urb, Urb, Urb, Urb, Urb, Urb, Urb, Urb, Urb, Uu^Vu, Urb, Urb, Urb, Urb, Uu^Tf, Urb, Urb, Urb, Urb, Urb, Urb, Urb, Urb, Urb, Urb, Urb, Urb, Urb, Urb, Urb, Urb, Urb, Uh, Urb, Urb, Xu
Xu, Urb, Urb, Urb, Urb, Urb, Urb, Urb, Urb, Urb, Uu^Tf, Urb, Urb, Urb, Urb, Urb, Uh, Urb, Urb, Urb, Urb, Urb, Urb, Urb, Urb, Uu^Vu, Urb, Urb, Urb, Urb, Urb, Urb, Urb, Urb, Urb, Urb, Urb, Urb, Urb, Xu
Xu, Urb, Uu^Tf, Urb, Urb, Urb, Urb, Urb, Urb, Urb, Urb, Urb, Urb, Urb, Urb, Urb, Urb, Urb, Urb, Urb, Urb, Urb, Urb, Urb, Urb, Urb, Urb, Urb, Urb, Urb, Urb, Urb, Urb, Urb, Urb, Urb, Urb, Uu^Vu, Urb, Xu
Xu, Urb, Urb, Urb, Urb, Urb, Urb, Urb, Urb, Urb, Urb, Urb, Urb, Urb, Urb, Urb, Urb, Urb, Urb, Urb, Urb, Urb, Urb, Urb, Urb, Urb, Urb, Urb, Urb, Urb, Urb, Urb, Urb, Urb, Urb, Urb, Urb, Urb, Urb, Xu
Xu, Xu, Xu, Xu, Xu, Xu, Xu, Xu, Xu, Xu, Xu, Xu, Xu, Xu, Xu, Xu, Xu, Xu, Xu, Xu, Xu, Xu, Xu, Xu, Xu, Xu, Xu, Xu, Xu, Xu, Xu, Xu, Xu, Xu, Xu, Xu, Xu, Xu, Xu, Xu
