border_size=1
usage=map

Xu, Xu, Xu, Xu, Xu, Xu, Xu, Xu, Xu, Xu, Xu, Xu, Xu, Xu, Xu, Xu, Xu, Xu, Xu, Xu, Xu, Xu, Xu, Xu, Xu, Xu, Xu, Xu, Xu, Xu, Xu, Xu, Xu, Xu, Xu, Xu, Xu, Xu, Xu, Xu, Xu, Xu
Xu, Uue, Uue, Uue, Uue, Uue, Uue, Uue, Uue, Uue, Uue, Uue, Uue, Uue, Uue, Uue, Uue, Uue, Uue, Uue, Uue, Uue, Uue, Uue, Uue, Uue, Uue, Uue, Uue, Uue, Uue, Uue, Uue, Uue, Uue, Uue, Uue, Uue, Uue, Uue, Uue, Xu
Xu, Uue, Uue, Uue, Uue, Uue, Uue, Uue, Uue, Uue, Uue, Uue, Uh, Uue, Uue, Uue, Uue, Uue, Uu^Tf, Uue, Uue, Uue, Uue, Uue, Uue, Uue, Uue, Uue, Uue, Uue, Uue, Uue, Uue, Uue, Uue, Uu^Vu, Uue, Uue, Uue, Uue, Uue, Xu
Xu, Uue, Uue, Uue, Uue, Uue, Uue, Uue, Uue, Uue, Uu^Tf, Uue, Uue, Uue, Uue, Uue, Uue, Uue, Uue, Uue, Uue, Uue, Uue, Uue, Uue, Uue, Uue, Uue, Uue, Uue, Uue, Uue, Uue, Uue, Uue, Uh, Uue, Uue, Uue, Uue, Uue, Xu
Xu, Uue, Uu^Tf, Uue, Xor, Xor, Xor, Uue, Uue, Xor, Xor, Xor, Xor, Xor, Uue, Uh, Xor, Xor, Xor, Xor, Xor, Uue, Uue, Xor, Xor, Xor, Xor, Xor, Uue, Uue, Xor, Xor, Xor, Xor, Xor, Uue, Uue, Urb, Uue, Uu^Tf, Uue, Xu
Xu, Uue, Uue, Uue, Uue, Uue, Uue, Uue, Uue, Uue, Uue, Uue, Uue, Uue, Uue, Uue, Uue, Uue, Uue, Uue, Uue, Uue, Uue, Uue, Uue, Uue, Uue, Uue, Uue, Uue, Uue, Uu^Tf, Uue, Uue, Uue, Uue, Uue, Uue, Uh, Uue, Uue, Xu
Xu, Uue, Uue, Uue, Uu^Vu, Uue, Iwo^Vhcr, Uue, Uue, Uue, Uue, Uue, Uue, Urb^Ebn, Iwo^Vhcr, Uue, Uue, Uue, Uh, Uue, Uue, Uue, Iwo^Vhcr, Uu^Tf, Uue, Uue, Uue, Urb^Ebn, Uue, Uue, Iwo^Vhcr, Uue, Uue, Uue, Uue, Uue, Uue, Uue, Uue, Uue, Uue, Xu
Xu, Uue, Uue, Uue, Uue, Uue, Uue, Uue, Uue, Uue, Uue, Uue, Uue, Uue, Uue, Uu^Tf, Uu^Vu, Uue, Uue, Uue, Uue, Uue, Uue, Uue, Uue, Uue, Uue, Uue, Uue, Uue, Uue, Uue, Uue, Uue, Uue, Uue, Uue, Uue, Uue, Uue, Uue, Xu
Xu, Uue, Uue, Uue, Uue, Uue, Uue, Uu^Tf, Uue, Uue, Uue, Uue, Uue, Uue, Uue, Uue, Uue, Uue, Uue, Uue, Uue, Uh, Uue, Uue, Uue, Uue, Uue, Uue, Uu^Vu, Uue, Uue, Uue, Uue, Uue, Uue, Uue, Uue, Uue, Uue, Uue, Uue, Xu
Xu, Uue, Uue, Uue, Xor, Xor, Xor, Uue, Uue, Xor, Xor, Xor, Xor, Xor, Uue, Uue, Xor, Xor, Xor, Xor, Xor, Uue, Uue, Xor, Xor, Xor, Xor, Xor, Uue, Uue, Xor, Xor, Xor, Xor, Xor, Uue, Uu^Tf, Xor, Uue, Uue, Uue, Xu
Xu, Uue, Uue, Uue, Uue, Uue, Uue, Uue, Uue, Uue, Uue, Uue, Uue, Uue, Uue, Uue, Uue, Uue, Uue, Uue, Uue, Uue, Uue, Uue, Uh, Uue, Uue, Uue, Uu^Tf, Uue, Uue, Uue, Uue, Uue, Uue, Uue, Uue, Uue, Uue, Uue, Uue, Xu
Xu, Uue, Uue, Uue, Uh, Uue, Uue, Uue, Uue, Uue, Uue, Uue, Uue, Uue, Uue, Uue, Uue, Uue, Uue, Uue, Uu^Tf, Uue, Uue, Uue, Uue, Uue, Uue, Uue, Uue, Uue, Uue, Uue, Uue, Uue, Uue, Uue, Uue, Uue, Uue, Uue, Uue, Xu
Xu, Uue, Cud, Cud, Uue, Uue, Uue, Uue, Uue, Uue, Uue, Uue, Uu^Tf, Uue, Uue, Uue, Uue, Uue, Uue, Uue, Uue, Uue, Uue, Uue, Uue, Uue, Uue, Uh, Uue, Uue, Uue, Uue, Uue, Uue, Uue, Uue, Cud, Cud, Uue, Uue, Uue, Xu
Xu, Urb, Cud, Kud, Cud, Uue, Iwo^Vhcr, Urb^Edb, Uue, Uu^Vu, Uue, Uue, Uue, Uue, Iwo^Vhcr, Uue, Uue, Uue, Uue, Uue, Uue, Uue, Iwo^Vhcr, Uue, Uue, Uue, Uue, Uue, Uue, Uue, Iwo^Vhcr, Uue, Uue, Uue, Uue, Uue, Cud, Kud, Cud, Uue, Uue, Xu
Xu, Uue, Uue, Cud, Cud, Ur, Ur, Uue, Uue, Ur, Ur, Ur, Ur, Ur, Uue, Uue, Ur, Ur, Ur, Ur, Ur, Uu^Vu, Uue, Ur, Ur, Ur, Ur, Ur, Uue, Uue, Ur, Ur, Ur, Ur, Ur, Uue, Uue, Cud, Cud, Uue, Uue, Xu
Xu, Uue, Uue, Uue, Uue, Uue, Uue, Uue, Uue, Uue, Uh, Uue, Uue, Uue, Uue, Uue, Uue, Uue, Uue, Uue, Uue, Uue, Uue, Uue, Uue, Uu^Tf, Uue, Uue, Uue, Uue, Uue, Uue, Uue, Uu^Vu, Uue, Uue, Uue, Uue, Uue, Uue, Uue, Xu
Xu, Uue, Uue, Uue, Uue, Uue, Uue, Uue, Uue, Uue, Uue, Uue, Uue, Uue, Uue, Uue, Uue, Uu^Tf, Uue, Uue, Uue, Uue, Uue, Uue, Uue, Uue, Uue, Uue, Uue, Uue, Uue, Uue, Uue, Uh, Uue, Uue, Uue, Uue, Uue, Uue, Uue, Xu
Xu, Uue, Uue, Uue, Uue, Uue, Uue, Uue, Uue, Uu^Tf, Uue, Uue, Uue, Uh, Uue, Uue, Uue, Uue, Uue, Uue, Uue, Uue, Uue, Uue, Uue, Uue, Uue, Uue, Uue, Uue, Uue, Uue, Uue, Uue, Uue, Uue, Uue, Uue, Uue, Uue, Uue, Xu
Xu, Uue, Uue, Uue, Uue, Uue, Uue, Uue, Uue, Uue, Uue, Uue, Uue, Uue, Uue, Uue, Uue, Uue, Uue, Uue, Uue, Uue, Uue, Uue, Uue, Uue, Uue, Uue, Uue, Uue, Uue, Uue, Uue, Uue, Uue, Uue, Uh, Uue, Uu^Tf, Uue, Uue, Xu
Xu, Uue, Uu^Vu, Uue, Xor, Xor, Xor, Uue, Uue, Xor, Xor, Xor, Xor, Xor, Uue, Uue, Xor, Xor, Xor, Xor, Xor, Uue, Uue, Xor, Xor, Xor, Xor, Xor, Uue, Uue, Xor, Xor, Xor, Xor, Xor, Uue, Uue, Xor, Uue, Uue, Uue, Xu
Xu, Uue, Uue, Uue, Uue, Uue, Iwo^Vhcr, Uue, Uue, Uue, Uue, Uue, Uue, Urb^Ebn, Iwo^Vhcr, Uue, Uue, Uue, Uue, Uue, Uue, Uue, Iwo^Vhcr, Uue, Uue, Uue, Uue, Urb^Ebn, Uue, Uue, Iwo^Vhcr, Uue, Uue, Uue, Uue, Uue, Uue, Uue, Uue, Uh, Uue, Xu
Xu, Uue, Uue, Uue, Uue, Uue, Uue, Uue, Uue, Uue, Uue, Uue, Uue, Uue, Uu^Tf, Uue, Uue, Uue, Uue, Uh, Uue, Uue, Uue, Uue, Uue, Uue, Uu^Vu, Uue, Uue, Uue, Uue, Uue, Uue, Uue, Uue, Uue, Uue, Uue, Uue, Uue, Uue, Xu
Xu, Uue, Uue, Uue, Uue, Uue, Uu^Tf, Uue, Uue, Uue, Uue, Uue, Uue, Uue, Uue, Uue, Uue, Uue, Uue, Uue, Uue, Uue, Uue, Uue, Uue, Uue, Uue, Uue, Uue, Uue, Uue, Uue, Uue, Uue, Uue, Uue, Uue, Urb, Uu^Vu, Uue, Uue, Xu
Xu, Uue, Uue, Uue, Uue, Uue, Uue, Uue, Uue, Uue, Uue, Uue, Uue, Uue, Uue, Uue, Uue, Uue, Uue, Uue, Uue, Uue, Uh, Uue, Uue, Uue, Uue, Uue, Uue, Uue, Uue, Uue, Uue, Uue, Uue, Uu^Tf, Uue, Uue, Uue, Uue, Uue, Xu
Xu, Uue, Uh, Uue, Uue, Uue, Uue, Uue, Uue, Uue, Uue, Uue, Uue, Uue, Uue, Uue, Uue, Uue, Uue, Uue, Uue, Uue, Uue, Uue, Uue, Uue, Uue, Uu^Tf, Uue, Uue, Uue, Uue, Uue, Uue, Uue, Uue, Uue, Uue, Uue, Uue, Uue, Xu
Xu, Uue, Uue, Uue, Uue, Uue, Uue, Uue, Uue, Uue, Uue, Uue, Uue, Uue, Uue, Uue, Uue, Uue, Uue, Uu^Tf, Uue, Uue, Uue, Uue, Uue, Uh, Uue, Uue, Uue, Uue, Uue, Uue, Uue, Uue, Uue, Uue, Uue, Uue, Uue, Uue, Uue, Xu
Xu, Uue, Uue, Uue, Uue, Uue, Uue, Uue, Uue, Uue, Uue, Uue, Uue, Uue, Uue, Uue, Uue, Uue, Uue, Uue, Uue, Uue, Uue, Uue, Uue, Uue, Uue, Uue, Uue, Uue, Uue, Uue, Uue, Uue, Uue, Uue, Uue, Uue, Uue, Uue, Uue, Xu
Xu, Xu, Xu, Xu, Xu, Xu, Xu, Xu, Xu, Xu, Xu, Xu, Xu, Xu, Xu, Xu, Xu, Xu, Xu, Xu, Xu, Xu, Xu, Xu, Xu, Xu, Xu, Xu, Xu, Xu, Xu, Xu, Xu, Xu, Xu, Xu, Xu, Xu, Xu, Xu, Xu, Xu
