border_size=1
usage=map

Xu, Xu, Xu, Xu, Xu, Xu, Xu, Xu, Xu, Xu, Xu, Xu, Xu, Xu, Xu, Xu, Xu, Xu, Xu, Xu, Xu, Xu, Xu, Xu, Xu, Xu, Xu, Xu, Xu, Xu, Xu, Xu, Xu, Xu, Xu, Xu, Xu, Xu
Xu, Uue, Uue, Uue, Uue, Uue, Uue, Uue, Uue, Uue, Uue, Uue, Uue, Uue, Uue, Uue, Uue, Uue, Uue, Uue, Uue, Uue, Uue, Uue, Uue, Uue, Uue, Uue, Uue, Uue, Uue, Uue, Uue, Uue, Uue, Uue, Uue, Xu
Xu, Uue, Uue, Uue, Uue, Uue, Uue, Uue, Uue, Uue, Uue, Uue, Uue, Uue, Uue, Uue, Uue, Uue, Uue, Uue, Uue, Uue, Uue, Uue, Uue, Uu^Tf, Uue, Uue, Uue, Uue, Uue, Uue, Uue, Uue, Uue, Uue, Uue, Xu
Xu, Uue, Uue, Uue, Uue, Uue, Uue, Uue, Uue, Uue, Uue, Uue, Uue, Uue, Uue, Uue, Uue, Uu^Tf, Uue, Uh, Uue, Uue, Uue, Uue, Uue, Uue, Uue, Uue, Uue, Uue, Uue, Uue, Chr, Chr, Uue, Uue, Uue, Xu
Xu, Uue, Uue, Uue, Uue, Uue, Uue, Uue, Uue, Uu^Tf, Uue, Uue, Uue, Uue, Uue, Uue, Uue, Uue, Uue, Uue, Uue, Uue, Uue, Uue, Uue, Uue, Uue, Uue, Uue, Uue, Uue, Uue, Chr, Khr, Chr, Uue, Uue, Xu
Xu, Uue, Uue, Uue, Uu^Vu, Xoa, Xoa, Xoa, Xoa, Xoa, Xoa, Xoa, Xoa, Xoa, Xoa, Xoa, Xoa, Xoa, Xoa, Urb, Xoa, Xoa, Xoa, Xoa, Xoa, Xoa, Xoa, Xoa, Xoa, Xoa, Xoa, Xoa, Xoa, Chr, Chr, Uue, Uue, Xu
Xu, Uue, Uh, Uue, Uue, Xoa, Uue, Uue, Uue, Uue, Uue, Uue, Uue, Uue, Uue, Uue, Uu^Vu, Uue, Uue, Uue, Uue, Uue, Uue, Uue, Uue, Uue, Uue, Uue, Uue, Uue, Uu^Tf, Uue, Xoa, Uue, Uue, Uue, Uue, Xu
Xu, Uue, Uue, Uue, Uue, Xoa, Uue, Uue, Uue, Uue, Uue, Urb^Ebn, Uue, Uue, Uue, Uue, Uue, Uue, Uue, Uue, Uue, Uue, Uu^Tf, Uue, Uue, Uh, Uue, Uue, Uu^Vu, Uue, Uue, Uue, Xoa, Uue, Uue, Uue, Uue, Xu
Xu, Uue, Uue, Uue, Uue, Xoa, Uue, Uue, Uue, Uue, Uue, Uue, Uue, Uue, Uu^Tf, Uue, Uue, Uue, Uue, Uue, Uue, Uue, Uue, Uue, Uue, Uue, Uue, Uue, Uue, Uue, Uue, Uue, Xoa, Uue, Uue, Uue, Uue, Xu
Xu, Uue, Uue, Uue, Uue, Xoa, Uu^Tf, Uue, Uue, Xoa, Xoa, Xoa, Xoa, Xoa, Xoa, Xoa, Xoa, Xoa, Urb^Ebn, Urb, Xoa, Xoa, Xoa, Xoa, Xoa, Xoa, Xoa, Xoa, Xoa, Uue, Uue, Uue, Xoa, Uue, Uue, Uue, Uue, Xu
Xu, Uue, Uue, Uue, Uue, Xoa, Uue, Uue, Uh, Xoa, Uue, Uue, Uue, Uue, Uue, Uue, Uue, Uue, Uue, Uue, Uue, Uue, Uue, Uue, Uue, Uue, Uue, Uue, Xoa, Uue, Uue, Uue, Xoa, Uue, Uue, Uu^Tf, Uue, Xu
Xu, Uue, Uue, Uue, Uue, Xoa, Uue, Uue, Uue, Xoa, Uue, Uue, Uue, Uue, Uue, Uue, Uue, Uue, Uue, Uue, Uue, Uue, Uue, Uue, Uue, Uue, Uue, Uu^Tf, Xoa, Uue, Uue, Uh, Xoa, Uue, Uue, Uue, Uue, Xu
Xu, Uue, Uue, Uue, Uue, Xoa, Uue, Uue, Uue, Xoa, Uue, Uh, Uue, Uue, Uue, Uue, Uue, Uue, Uue, Uu^Tf, Uue, Uue, Uue, Uue, Uue, Uue, Uue, Uue, Xoa, Uue, Uue, Uue, Xoa, Uue, Uue, Uue, Uue, Xu
Xu, Uue, Uue, Uue, Uue, Xoa, Uue, Uue, Uue, Xoa, Uue, Uu^Tf, Uue, Xoa, Xoa, Xoa, Xoa, Xoa, Xoa, Urb, Xoa, Xoa, Xoa, Xoa, Xoa, Uue, Uue, Uue, Xoa, Uue, Uue, Uue, Xoa, Uue, Uh, Uue, Uue, Xu
Xu, Uue, Cud, Cud, Uue, Xoa, Uue, Uue, Uue, Xoa, Uue, Uue, Uue, Xoa, Uh, Uue, Uue, Uue, Uue, Uue, Uue, Uue, Uue, Uue, Xoa, Uue, Uue, Uue, Xoa, Uue, Uue, Uue, Cud, Cud, Uue, Uue, Uue, Xu
Xu, Urb, Cud, Kud, Cud, Xoa, Uue, Urb^Edb, Urb, Urb, Urb, Urb, Urb, Urb, Urb, Urb, Urb, Urb, Urb, Urb, Urb, Urb, Urb, Urb, Urb, Urb, Urb, Urb, Urb, Urb, Urb, Uue, Cud, Kud, Cud, Uue, Uue, Xu
Xu, Uue, Uue, Cud, Cud, Urb, Uue, Urb, Urb, Urb, Urb, Urb, Urb, Urb, Urb, Urb, Urb, Urb, Urb, Urb, Urb, Urb, Urb, Urb, Urb, Urb, Urb, Urb, Urb, Urb, Urb, Uue, Urb, Cud, Cud, Uue, Uue, Xu
Xu, Uue, Uue, Uue, Uue, Xoa, Uue, Urb, Urb, Urb, Urb, Urb, Urb, Urb, Urb, Urb, Urb, Urb, Urb, Urb, Urb, Urb, Urb, Urb, Urb, Urb, Urb, Urb, Urb, Urb, Urb, Uue, Xoa, Uue, Uue, Uue, Uue, Xu
Xu, Uue, Uu^Vu, Uue, Uue, Xoa, Uue, Uue, Uu^Tf, Xoa, Uue, Uue, Uue, Xoa, Xoa, Xoa, Xoa, Xoa, Xoa, Urb, Xoa, Xoa, Xoa, Xoa, Xoa, Uue, Uue, Uue, Xoa, Uue, Uue, Uue, Xoa, Uue, Uue, Uue, Uue, Xu
Xu, Uue, Uue, Uue, Uue, Xoa, Uue, Uue, Uue, Xoa, Uue, Uue, Uue, Uue, Uu^Vu, Uue, Uue, Uue, Uue, Uue, Uue, Uue, Uue, Uue, Uue, Uue, Uue, Uue, Xoa, Uue, Uue, Uue, Xoa, Uue, Uue, Uue, Uue, Xu
Xu, Uue, Uue, Uue, Uue, Xoa, Uue, Uue, Uue, Xoa, Uue, Uue, Uue, Uue, Uue, Uue, Uue, Uue, Uue, Uue, Uue, Uue, Uue, Uh, Uue, Uue, Uu^Vu, Uue, Xoa, Uu^Tf, Uue, Uue, Xoa, Uue, Uue, Uue, Uue, Xu
Xu, Uue, Uue, Uh, Uue, Xoa, Uue, Uue, Uue, Xoa, Uue, Uue, Uue, Uue, Uue, Uue, Uue, Uue, Uue, Uue, Uue, Uu^Tf, Uue, Uue, Uue, Uue, Uue, Uue, Xoa, Uue, Uue, Uue, Xoa, Uue, Uue, Uue, Uue, Xu
Xu, Uue, Uue, Uue, Uue, Xoa, Uue, Uue, Uue, Xoa, Xoa, Xoa, Xoa, Xoa, Xoa, Xoa, Xoa, Xoa, Xoa, Urb, Xoa, Xoa, Xoa, Xoa, Xoa, Xoa, Xoa, Xoa, Xoa, Uue, Uue, Uue, Xoa, Uue, Uue, Uue, Uue, Xu
Xu, Uue, Uue, Uue, Uue, Xoa, Uh, Uue, Uue, Uue, Uue, Uue, Uue, Uue, Uue, Uue, Uue, Uue, Uue, Uue, Uue, Uue, Uue, Uue, Urb^Ebn, Uue, Uue, Uue, Uue, Uue, Uue, Uue, Xoa, Uue, Uue, Uue, Uue, Xu
Xu, Uue, Uue, Uue, Uue, Xoa, Uue, Uue, Uue, Uue, Uue, Uue, Uue, Uue, Uue, Uue, Uue, Uue, Uue, Uue, Uue, Uue, Uue, Uue, Uue, Uue, Uue, Uue, Uue, Uh, Uue, Uue, Xoa, Uue, Uu^Tf, Uue, Uue, Xu
Xu, Uue, Uue, Uue, Uue, Xoa, Uue, Uu^Vu, Uue, Uh, Uue, Uue, Uue, Uue, Uue, Uue, Uue, Uue, Uue, Uue, Uue, Uue, Uue, Uue, Uue, Uue, Uu^Tf, Uue, Uue, Uue, Uue, Uue, Xoa, Uue, Uue, Uue, Uue, Xu
Xu, Uue, Uue, Uue, Uue, Xoa, Xoa, Xoa, Xoa, Xoa, Xoa, Xoa, Xoa, Xoa, Xoa, Xoa, Xoa, Xoa, Xoa, Urb, Xoa, Xoa, Xoa, Xoa, Xoa, Xoa, Xoa, Xoa, Xoa, Xoa, Xoa, Xoa, Xoa, Urb, Uue, Uue, Uue, Xu
Xu, Uue, Uue, Uue, Uue, Uue, Uue, Uue, Uue, Uue, Uu^Tf, Uue, Uh, Uue, Uue, Uue, Uue, Uue, Uue, Uue, Uue, Uue, Uue, Uue, Uue, Uue, Uue, Uue, Uue, Uue, Uue, Uu^Vu, Uue, Uue, Uue, Uue, Uue, Xu
Xu, Uue, Uu^Tf, Uue, Uue, Uue, Uue, Uue, Uue, Uue, Uue, Uue, Uue, Uue, Uue, Uue, Uue, Uue, Uue, Uue, Uue, Uue, Uue, Uue, Uue, Uue, Uue, Uue, Uue, Uue, Uue, Uue, Uue, Uue, Uue, Uh, Uue, Xu
Xu, Uue, Uue, Uue, Uue, Uue, Uue, Uue, Uue, Uue, Uue, Uue, Uue, Uue, Uue, Uh, Uue, Uue, Uue, Uue, Uue, Uue, Uue, Uue, Uue, Uue, Uue, Uue, Uue, Uue, Uue, Uu^Tf, Uue, Uue, Uue, Uue, Uue, Xu
Xu, Uue, Uue, Uue, Uue, Uue, Uue, Uue, Uue, Uue, Uue, Uue, Uue, Uue, Uue, Uue, Uue, Uue, Uue, Uue, Uue, Uue, Uue, Uue, Uue, Uue, Uue, Uue, Uue, Uue, Uue, Uue, Uue, Uue, Uue, Uue, Uue, Xu
Xu, Xu, Xu, Xu, Xu, Xu, Xu, Xu, Xu, Xu, Xu, Xu, Xu, Xu, Xu, Xu, Xu, Xu, Xu, Xu, Xu, Xu, Xu, Xu, Xu, Xu, Xu, Xu, Xu, Xu, Xu, Xu, Xu, Xu, Xu, Xu, Xu, Xu
