border_size=1
usage=map

Xu, Xu, Xu, Xu, Xu, Xu, Xu, Xu, Xu, Xu, Xu, Xu, Xu, Xu, Xu, Xu, Xu, Xu, Xu, Xu, Xu, Xu, Xu, Xu, Xu, Xu, Xu, Xu, Xu, Xu, Xu, Xu, Xu, Xu, Xu, Xu, Xu, Xu, Xu, Xu
Xu, Urb, Urb, Urb, Urb, Urb, Urb, Urb, Urb, Urb, Urb, Urb, Urb, Urb, Urb, Urb, Urb, Urb, Urb, Urb, Urb, Urb, Urb, Urb, Urb, Urb, Urb, Urb, Urb, Urb, Urb, Urb, Urb, Urb, Urb, Urb, Urb, Urb, Urb, Xu
Xu, Urb, Uue, Uue, Uue, Uu^Edb, Uue, Uue, Uue, Uue, Uue, Uue, Uu^Edb, Uue, Uue, Uue, Uue, Uue, Uue, Uu^Edb, Ur, Urb, Urb, Qxu, Urb, Urb, Urb, Urb, Qxu, Urb, Urb, Urb, Urb, Qxu, Urb, Urb, Urb, Urb, Urb, Xu
Xu, Urb, Uue, Uue, Uu^Edb, Uue, Uue, Uue, Uue, Uue, Uue, Uu^Edb, Uue, Uue, Uue, Uue, Uue, Uue, Uu^Edb, Uue, Ur, Urb, Qxu, Urb, Urb, Urb, Urb, Qxu, Urb, Urb, Urb, Urb, Qxu, Urb, Urb, Urb, Urb, Qxu, Urb, Xu
Xu, Urb, Uue, Uu^Edb, Uue, Uue, Uue, Uue, Uue, Uue, Uu^Edb, Uue, Uue, Uue, Uue, Uue, Uue, Uu^Edb, Uue, Uue, Ur, Qxu, Urb, Urb, Urb, Urb, Qxu, Urb, Urb, Urb, Urb, Qxu, Urb, Urb, Urb, Urb, Qxu, Urb, Urb, Xu
Xu, Urb, Uu^Edb, Uue, Uue, Uue, Uue, Uue, Uue, Uu^Edb, Uue, Uue, Uue, Uue, Uue, Uue, Uu^Edb, Uue, Uue, Uue, Ur, Urb, Urb, Urb, Urb, Qxu, Urb, Urb, Urb, Urb, Qxu, Urb, Urb, Urb, Urb, Qxu, Urb, Urb, Urb, Xu
Xu, Urb, Uue, Uue, Uue, Uue, Uue, Uue, Uu^Edb, Uue, Uue, Uue, Urb^Ebn, Uue, Uue, Uu^Edb, Uue, Uue, Uue, Uue, Ur, Urb, Urb, Urb, Qxu, Urb^Ebn, Urb, Urb, Urb, Qxu, Urb, Urb, Urb, Urb, Qxu, Urb, Urb, Urb, Urb, Xu
Xu, Urb, Uue, Uue, Uue, Uue, Uue, Uu^Edb, Uue, Uue, Uue, Uue, Uue, Uue, Uu^Edb, Uue, Uue, Uue, Uue, Uue, Ur, Urb, Urb, Qxu, Urb, Urb, Urb, Urb, Qxu, Urb, Urb, Urb, Urb, Qxu, Urb, Urb, Urb, Urb, Urb, Xu
Xu, Urb, Uue, Uue, Uue, Uue, Uu^Edb, Uue, Uue, Uue, Uue, Uue, Uue, Uu^Edb, Uue, Uue, Uue, Uue, Uue, Uue, Ur, Urb, Qxu, Urb, Urb, Urb, Urb, Qxu, Urb, Urb, Urb, Urb, Qxu, Urb, Urb, Urb, Urb, Qxu, Urb, Xu
Xu, Urb, Uue, Uue, Uue, Uu^Edb, Uue, Uue, Uue, Uue, Uue, Uue, Uu^Edb, Uue, Uue, Uue, Uue, Uue, Uue, Uu^Edb, Ur, Qxu, Urb, Urb, Urb, Urb, Qxu, Urb, Urb, Urb, Urb, Qxu, Urb, Urb, Urb, Urb, Qxu, Urb, Urb, Xu
Xu, Urb, Uue, Uue, Uu^Edb, Uue, Uue, Uue, Uue, Uue, Uue, Uu^Edb, Uue, Uue, Uue, Uue, Uue, Uue, Uu^Edb, Uue, Ur, Urb, Urb, Urb, Urb, Qxu, Urb, Urb, Urb, Urb, Qxu, Urb, Urb, Urb, Urb, Qxu, Urb, Urb, Urb, Xu
Xu, Urb, Uue, Uu^Edb, Uue, Uue, Uue, Uue, Uue, Uue, Uu^Edb, Uue, Uue, Uue, Uue, Uue, Uue, Uu^Edb, Uue, Uue, Ur, Urb, Urb, Urb, Qxu, Urb, Urb, Urb, Urb, Qxu, Urb, Urb, Urb, Urb, Qxu, Urb, Urb, Urb, Urb, Xu
Xu, Urb, Cud, Cud, Uue, Uue, Uue, Uue, Uue, Uu^Edb, Uue, Uue, Uue, Uue, Uue, Uue, Uu^Edb, Uue, Uue, Uue, Ur, Urb, Urb, Qxu, Urb, Urb, Urb, Urb, Qxu, Urb, Urb, Urb, Urb, Qxu, Cud, Cud, Urb, Urb, Urb, Xu
Xu, Urb, Cud, Kud, Cud, Uue, Uue, Urb^Edb, Uu^Edb, Uue, Uue, Uue, Uue, Uue, Uue, Uu^Edb, Uue, Uue, Uue, Uue, Ur, Urb, Qxu, Urb, Urb, Urb, Urb, Qxu, Urb, Urb, Urb, Urb, Qxu, Urb, Cud, Kud, Cud, Qxu, Urb, Xu
Xu, Urb, Ur, Cud, Cud, Ur, Ur, Ur, Ur, Ur, Ur, Ur, Ur, Ur, Ur, Ur, Ur, Ur, Ur, Ur, Ur, Ur, Ur, Ur, Ur, Ur, Ur, Ur, Ur, Ur, Ur, Ur, Ur, Ur, Ur, Cud, Cud, Ur, Urb, Xu
Xu, Urb, Isa, Isa, Isa, Iwo, Isa, Isa, Isa, Iwo, Isa, Isa, Isa, Iwo, Isa, Isa, Isa, Iwo, Isa, Isa, Ur, Chr, Chr, Uu, Uu, Uu, Uu, Chr, Chr, Uu, Uu, Uu, Uu, Chr, Chr, Uu, Uu, Uu, Urb, Xu
Xu, Urb, Isa, Isa, Iwo, Isa, Isa, Isa, Iwo, Isa, Isa, Isa, Iwo, Isa, Isa, Isa, Iwo, Isa, Isa, Isa, Ur, Chr, Uu, Uu, Uu, Uu, Chr, Chr, Uu, Uu, Uu, Uu, Chr, Chr, Uu, Uu, Uu, Uu, Urb, Xu
Xu, Urb, Isa, Iwo, Isa, Isa, Isa, Iwo, Isa, Isa, Isa, Iwo, Isa, Isa, Isa, Iwo, Isa, Isa, Isa, Iwo, Ur, Uu, Uu, Uu, Uu, Chr, Chr, Uu, Uu, Uu, Uu, Chr, Chr, Uu, Uu, Uu, Uu, Chr, Urb, Xu
Xu, Urb, Iwo, Isa, Isa, Isa, Iwo, Isa, Isa, Isa, Iwo, Isa, Isa, Isa, Iwo, Isa, Isa, Isa, Iwo, Isa, Ur, Uu, Uu, Uu, Chr, Chr, Uu, Uu, Uu, Uu, Chr, Chr, Uu, Uu, Uu, Uu, Chr, Chr, Urb, Xu
Xu, Urb, Isa, Isa, Isa, Iwo, Isa, Isa, Isa, Iwo, Isa, Isa, Isa, Iwo, Isa, Isa, Isa, Iwo, Isa, Isa, Ur, Uu, Uu, Chr, Chr, Uu, Uu, Uu, Uu, Chr, Chr, Uu, Uu, Uu, Uu, Chr, Chr, Uu, Urb, Xu
Xu, Urb, Isa, Isa, Iwo, Isa, Isa, Isa, Iwo, Isa, Isa, Isa, Urb^Ebn, Isa, Isa, Isa, Iwo, Isa, Isa, Isa, Ur, Uu, Chr, Chr, Uu, Urb^Ebn, Uu, Uu, Chr, Chr, Uu, Uu, Uu, Uu, Chr, Chr, Uu, Uu, Urb, Xu
Xu, Urb, Isa, Iwo, Isa, Isa, Isa, Iwo, Isa, Isa, Isa, Iwo, Isa, Isa, Isa, Iwo, Isa, Isa, Isa, Iwo, Ur, Chr, Chr, Uu, Uu, Uu, Uu, Chr, Chr, Uu, Uu, Uu, Uu, Chr, Chr, Uu, Uu, Uu, Urb, Xu
Xu, Urb, Iwo, Isa, Isa, Isa, Iwo, Isa, Isa, Isa, Iwo, Isa, Isa, Isa, Iwo, Isa, Isa, Isa, Iwo, Isa, Ur, Chr, Uu, Uu, Uu, Uu, Chr, Chr, Uu, Uu, Uu, Uu, Chr, Chr, Uu, Urb, Uu, Uu, Urb, Xu
Xu, Urb, Isa, Isa, Isa, Iwo, Isa, Isa, Isa, Iwo, Isa, Isa, Isa, Iwo, Isa, Isa, Isa, Iwo, Isa, Isa, Ur, Uu, Uu, Uu, Uu, Chr, Chr, Uu, Uu, Uu, Uu, Chr, Chr, Uu, Uu, Uu, Uu, Chr, Urb, Xu
Xu, Urb, Isa, Isa, Iwo, Isa, Isa, Isa, Iwo, Isa, Isa, Isa, Iwo, Isa, Isa, Isa, Iwo, Isa, Isa, Isa, Ur, Uu, Uu, Uu, Chr, Chr, Uu, Uu, Uu, Uu, Chr, Chr, Uu, Uu, Uu, Uu, Chr, Chr, Urb, Xu
Xu, Urb, Isa, Iwo, Isa, Isa, Isa, Iwo, Isa, Isa, Isa, Iwo, Isa, Isa, Isa, Iwo, Isa, Isa, Isa, Iwo, Ur, Uu, Uu, Chr, Chr, Uu, Uu, Uu, Uu, Chr, Chr, Uu, Uu, Uu, Uu, Chr, Chr, Uu, Urb, Xu
Xu, Urb, Urb, Urb, Urb, Urb, Urb, Urb, Urb, Urb, Urb, Urb, Urb, Urb, Urb, Urb, Urb, Urb, Urb, Urb, Urb, Urb, Urb, Urb, Urb, Urb, Urb, Urb, Urb, Urb, Urb, Urb, Urb, Urb, Urb, Urb, Urb, Urb, Urb, Xu
Xu, Xu, Xu, Xu, Xu, Xu, Xu, Xu, Xu, Xu, Xu, Xu, Xu, Xu, Xu, Xu, Xu, Xu, Xu, Xu, Xu, Xu, Xu, Xu, Xu, Xu, Xu, Xu, Xu, Xu, Xu, Xu, Xu, Xu, Xu, Xu, Xu, Xu, Xu, Xu
