border_size=1
usage=map

Gg, Gg, Gg, Gg, Gg, Gg, Gg, Gg, Hh, Hh, Gg, Gg, Ff, Ff, Gg, Gg, Gg, Gg
Gg, Ff, Ff, Gg, Gg, Gg, Hh, Hh, Hh, Gg, Gg, Ff, Ff, Gg, Gg, Gg, Hh, Gg
Gg, Ff, 1 Kh, Ch, Ch, Gg, Gg, Gg, Gg, Gg, Ff, Ff, Gg, Gg, Hh, Hh, Gg, Gg
Gg, Gg, Ch, Ch, Gg, Gg, Ff, Ff, Gg, Gg, Gg, Ff, Gg, Hh, Hh, Gg, Gg, Gg
Gg, Gg, Gg, Gg, Gg, Ff, Ff, Gg, Gg, Hh, Gg, Gg, Gg, Gg, Ff, Ff, Gg, Gg
Gg, Hh, Gg, Gg, Ff, Ff, Gg, Gg, Hh, Hh, Gg, Gg, Ff, Ff, Ff, Gg, Gg, Gg
Gg, Gg, Gg, Ff, Ff, Gg, Gg, Hh, Hh, Gg, Gg, Ff, Ff, Gg, Gg, Gg, Hh, Hh
Gg, Gg, Gg, Gg, Gg, Gg, Hh, Gg, Gg, Gg, Ff, Ff, Gg, Gg, Gg, Ch, Ch, Gg
Gg, Gg, Hh, Hh, Gg, Gg, Gg, Gg, Ff, Ff, Gg, Gg, Gg, Hh, Gg, Ch, 2 Kh, Ch
Gg, Gg, Gg, Hh, Hh, Gg, Gg, Ff, Ff, Gg, Gg, Hh, Hh, Gg, Gg, Gg, Ch, Gg
Gg, Gg, Gg, Gg, Gg, Gg, Gg, Gg, Hh, Hh, Gg, Gg, Gg, Ff, Ff, Gg, Gg, Gg
Gg, Gg, Ff, Ff, Gg, Gg, Gg, Hh, Hh, Gg, Gg, Gg, Ff, Ff, Gg, Gg, Gg, Gg
