border_size=1
usage=map

Gg, Gg, Gg, Ff, Ff, Gg, Gg, Gg, Ww, Ww, Gg, Gg, Ff, Ff, Gg, Gg, Gg, Gg, Gg, Gg
Gg, Ff, Ff, Gg, Gg, Gg, Hh, Gg, Ww, Ww, Gg, Gg, Gg, Ff, Ff, Gg, Hh, Gg, Gg, Gg
Gg, Ff, 1 Kh, Ch, Ch, Gg, Hh, Gg, Ww, Ww, Gg, Hh, Gg, Gg, Ff, Gg, Gg, Gg, Hh, Gg
Gg, Gg, Ch, Ch, Gg, Gg, Gg, Gg, Ww, Ww, Gg, Gg, Hh, Gg, Ff, Ff, Gg, Hh, Hh, Gg
Gg, Gg, Gg, Gg, Gg, Ff, Ff, Gg, Ww, Ww, Gg, Gg, Gg, Gg, Gg, Ff, Ff, Gg, Gg, Gg
Gg, Hh, Gg, Gg, Ff, Ff, Gg, Gg, Ww, Ww, Gg, Ff, Ff, Gg, Gg, Gg, Ff, Ff, Gg, Gg
Gg, Gg, Gg, Ff, Ff, Gg, Gg, Hh, Ww, Ww, Gg, Gg, Ff, Ff, Gg, Gg, Gg, Ch, Ch, Gg
Gg, Gg, Hh, Gg, Gg, Gg, Hh, Gg, Ww, Ww, Gg, Gg, Gg, Hh, Gg, Gg, Ch, 2 Kh, Ch, Gg
Gg, Gg, Gg, Hh, Hh, Gg, Gg, Gg, Ww, Ww, Gg, Hh, Hh, Gg, Gg, Gg, Gg, Ch, Gg, Gg
Gg, Gg, Gg, Gg, Gg, Gg, Gg, Gg, Ww, Ww, Gg, Gg, Gg, Ff, Ff, Gg, Gg, Gg, Gg, Gg
Gg, Ff, Ff, Gg, Gg, Gg, Hh, Gg, Ww, Ww, Gg, Gg, Ff, Ff, Gg, Gg, Hh, Hh, Gg, Gg
Gg, Gg, Gg, Gg, Gg, Gg, Gg, Gg, Ww, Ww, Gg, Gg, Gg, Gg, Gg, Gg, Gg, Gg, Gg, Gg
